Welcome to Icecrown Citadel, mortal. Status: ALIVE.

MAIN
An Interactive Fiction by Jan Pobi
Release 1 / Serial number 260112 / Inform 7 v10.1.2 / D

ICC Entrance
You are now at the ICC entrance inside the citadel. Next to you is a repair man and infront of you is the next room with enemy units.

You can see an Entrance Teleporter here.

>?
That's not a verb I recognise.

>left
That's not a verb I recognise.

>north
Trash 1
You can see Trash Pack 1 here.

Available commands: fight, look, inventory, go <direction>.

>inventory
You are carrying nothing.

Available commands: fight, look, inventory, go <direction>.

>go
You'll have to say which compass direction to go in.

Available commands: fight, look, inventory, go <direction>.

>fight
You engage the trash pack. The raid moves in!

Trash fight: the raid cleaves through undead...
Trash cleared. You can move on.

Available commands: Trash is cleared. go <direction>, look, inventory.

>look
Trash 1
You can see Trash Pack 1 here.

Available commands: Trash is cleared. go <direction>, look, inventory.

>north
Boss Room 1
You can see Lord Marrowgar here.

Available commands: fight, look, inventory, go <direction>.

>north
Lord Marrowgar blocks the way. Type fight to start the encounter.

Available commands: fight, look, inventory, go <direction>.

>fight
You pull Lord Marrowgar! The boss encounter begins!

Boss fight: the encounter is underway...

Available commands: (in combat) wait, look, inventory, die (debug).

>look
Boss Room 1
You can see Lord Marrowgar here.

Boss fight: the encounter is underway...
A random raider fails a mechanic and takes huge damage!
Someone stands in bad stuff. Healer screams in chat.
Lord Marrowgar uses a raid-wide ability!

Available commands: (in combat) wait, look, inventory, die (debug).

>wait
Time passes.

Boss fight: the encounter is underway...
Lord Marrowgar uses a raid-wide ability!

Available commands: (in combat) wait, look, inventory, die (debug).

>look
Boss Room 1
You can see Lord Marrowgar here.

Boss fight: the encounter is underway...
Someone stands in bad stuff. Healer screams in chat.
Lord Marrowgar uses a raid-wide ability!

Available commands: (in combat) wait, look, inventory, die (debug).

>die
Open World Graveyard
The cold winds howl. You are at the graveyard outside the raid. You can only return by typing release spirit.

You died. Type release spirit.

>release
ICC Entrance
You stand at the gates of Icecrown Citadel.

You release your spirit and fly back to Icecrown Citadel. Status: ALIVE.

Your equipment is a bit damaged from dying.

You can still die and run back 2 more times before your gear becomes useless.

Available commands: (in combat) wait, look, inventory, die (debug).

>repair
You repair your gear. Everything feels solid again.

Available commands: (in combat) wait, look, inventory, die (debug).

>look
ICC Entrance
You stand at the gates of Icecrown Citadel.

Available commands: (in combat) wait, look, inventory, die (debug).

>north
Trash 1
You can see Trash Pack 1 here.

Trash fight: the raid cleaves through undead...
Trash cleared. You can move on.

Available commands: Trash is cleared. go <direction>, look, inventory.

>look
Trash 1
You can see Trash Pack 1 here.

Available commands: Trash is cleared. go <direction>, look, inventory.

* * *

Welcome to Icecrown Citadel, mortal. Status: ALIVE.

MAIN
An Interactive Fiction by Jan Pobi
Release 1 / Serial number 260112 / Inform 7 v10.1.2 / D

ICC Entrance
You are now at the ICC entrance inside the citadel. Next to you is a repair man and infront of you is the next room with enemy units.

You can see an Entrance Teleporter here.

>die
Open World Graveyard
You are at the graveyard outside the raid because you are DEAD. The cold winds howls. Other spirits are whispering to you. Do not listen to them. Go to the light. You can only return by typing release spirit.

You died. Type release spirit.

>look
Open World Graveyard
You are at the graveyard outside the raid because you are DEAD. The cold winds howl. Other spirits whisper to you. Do not listen to them. Go to the light. You can only return by typing release spirit.

>n
You are dead. Only release spirit works now.

>exit
You are dead. Only release spirit works now.

>release
ICC Entrance
You stand at the gates of Icecrown Citadel.

You release your spirit and fly back to Icecrown Citadel. Status: ALIVE.

Your equipment is a bit damaged from dying.

You can still die and run back 2 more times before your gear becomes useless.

Available commands: go <direction>, look, inventory, die (debug), repair (if needed).

* * *

>die
Open World Graveyard
You are at the graveyard outside the raid because you are DEAD. The cold winds howls. Other spirits are whispering to you. Do not listen to them. Go to the light. You can only return by typing release spirit.

You died. Type release spirit.

>release
ICC Entrance
You stand at the gates of Icecrown Citadel.

You release your spirit and fly back to Icecrown Citadel. Status: ALIVE.

Your equipment is a bit damaged from dying.

You can still die and run back 2 more times before your gear becomes useless.

Available commands: go <direction>, look, inventory, die (debug), repair (if needed).

>repair
You repair your gear. Everything feels solid again.

Available commands: go <direction>, look, inventory, die (debug), repair (if needed).

* * *

Welcome to Icecrown Citadel, mortal. Status: ALIVE.

MAIN
An Interactive Fiction by Jan Pobi
Release 1 / Serial number 260112 / Inform 7 v10.1.2 / D

ICC Entrance
You are now at the ICC entrance inside the citadel. Next to you is a repair man and infront of you is the next room with enemy units.

You can see an Entrance Teleporter here.

>lokk
That's not a verb I recognise.

>lok
That's not a verb I recognise.

>look
ICC Entrance
You are now at the ICC entrance inside the citadel. Next to you is a repair man and infront of you is the next room with enemy units.

You can see an Entrance Teleporter here.

Available commands: go <direction>, look, inventory, repair (if needed).

>w
You can't go that way.

Available commands: go <direction>, look, inventory, repair (if needed).

>n
Trash 1
You can see Trash Pack 1 here.

Available commands: fight, look, inventory, go <direction>.

>fight
You engage the trash pack. The raid moves in!

Trash fight: the raid cleaves through undead...
You have successfully cleared the trash mobs. You can move on.

Available commands: fight, look, inventory, go <direction>.

>look
Trash 1
You can see Trash Pack 1 here.

The dead Trash Pack 1 lies here. The trash pack is cleared. You can move onwards without consequences

Available commands: fight, look, inventory, go <direction>.

>n
Boss Room 1
You can see Lord Marrowgar here.

Available commands: fight, look, inventory, go <direction>.

>fight
You pull Lord Marrowgar! The boss encounter begins!

Lord Marrowgar begins Bone Storm!You have 5 seconds to type DODGE or you die.

Available commands: (in combat) wait, look, inventory, dodge (if asked), dps (if asked).

>dodge
You DODGE Bone Storm just in time!
Marrowgar follows up with Bone Graveyard - bone tombs trap players!
You have 5 seconds to type DPS.

Available commands: (in combat) wait, look, inventory, dodge (if asked), dps (if asked).

>dps
You burst the bone tombs with heavy DPS!
Lord Marrowgar is defeated! Loot drops: Coldwraith Bracers.
Type loot item to pick it up.

Available commands: fight, look, inventory, go <direction>.

>look
Boss Room 1
You can see Coldwraith Bracers and Lord Marrowgar here.

Lord Marrowgar lies defeated on the ground.

Available commands: fight, look, inventory, go <direction>.

>loot
Taken.

Available commands: fight, look, inventory, go <direction>.

>inventory
You are carrying:
  Coldwraith Bracers

Available commands: fight, look, inventory, go <direction>.

>look
Boss Room 1
You can see Lord Marrowgar here.

Lord Marrowgar lies defeated on the ground.

Available commands: fight, look, inventory, go <direction>.

>n
You can't go that way.

Available commands: fight, look, inventory, go <direction>.

>w
Trash 2
You can see Trash Pack 2 here.

Available commands: fight, look, inventory, go <direction>.

>fight
You engage the trash pack. The raid moves in!

Trash fight: the raid cleaves through undead...
You have successfully cleared the trash mobs. You can move on.

Available commands: fight, look, inventory, go <direction>.

>n
Boss Room 2
You can see Lady Deathwhisper here.

Available commands: fight, look, inventory, go <direction>.

>fight
You pull Lady Deathwhisper! The boss encounter begins!

Lady Deathwhisper summons adds!Type dps adds to kill them (you have 5 seconds).

Available commands: (in combat) wait, look, inventory, dodge (if asked), dps (if asked).

>dps adds
You obliterate the adds! Now burn the boss shield!
Type dps boss.

Available commands: (in combat) wait, look, inventory, dodge (if asked), dps (if asked).

>dps boss
I only understood you as far as wanting to dps.

>dps
No need to DPS here.

Available commands: (in combat) wait, look, inventory, dodge (if asked), dps (if asked).

>look
Too late! Her shield never drops and the raid wipes.

Open World Graveyard
You are DEAD and teleported to the graveyard outside the raid. The cold winds howls. Other spirits are whispering to you. Do not listen to them. Go to the light. You can only return by typing release spirit.

You died. Type release spirit.

>release
ICC Entrance
You are now at the ICC entrance inside the citadel. Next to you is a repair man and infront of you is the next room with enemy units.

You can see an Entrance Teleporter here.

You release your spirit and fly back to Icecrown Citadel. Status: ALIVE.

Your equipment is a bit damaged from dying.

You can still die and run back 2 more times before your gear becomes useless. Then you will NEED to repair it or otherwise you wont be able to fight.

Available commands: go <direction>, look, inventory, repair (if needed).

>teleport to 2
Boss Room 2
You can see Lady Deathwhisper here.

You step into the teleporter... Destination reached.
Boss Room 2
You can see Lady Deathwhisper here.

Available commands: fight, look, inventory, go <direction>.

>fight
You pull Lady Deathwhisper! The boss encounter begins!

Lady Deathwhisper summons adds!Type dps adds to kill them (you have 5 seconds).

Available commands: (in combat) wait, look, inventory, dodge (if asked), dps (if asked).

* * *

>dps adds
You obliterate the adds! Now burn the boss shield!
Type dps boss.

Available commands: (in combat) wait, look, inventory, dodge (if asked), dps (if asked).

>dps
No need to DPS here.

Available commands: (in combat) wait, look, inventory, dodge (if asked), dps (if asked).

>dps
Too late! Her shield never drops and the raid wipes.

Open World Graveyard
You are DEAD and teleported to the graveyard outside the raid. The cold winds howls. Other spirits are whispering to you. Do not listen to them. Go to the light. You can only return by typing release spirit.

You died. Type release spirit.

>release
ICC Entrance
You are now at the ICC entrance inside the citadel. Next to you is a repair man and infront of you is the next room with enemy units.

You can see an Entrance Teleporter here.

You release your spirit and fly back to Icecrown Citadel. Status: ALIVE.

Your equipment is a bit damaged from dying.

Careful: you can only die and run back 1 more time before your gear becomes useless.

Available commands: go <direction>, look, inventory, repair (if needed).

>repair
You have successfully repaired your gear. Durability on all of your gear is not back to full.

Available commands: go <direction>, look, inventory, repair (if needed).

>teleport to 2
Boss Room 2
You can see Lady Deathwhisper here.

You step into the teleporter... Destination reached.
Boss Room 2
You can see Lady Deathwhisper here.

Available commands: fight, look, inventory, go <direction>.

* * *

>dps adds
You obliterate the adds! Now burn the boss shield!
Type dps boss.

Available commands: (in combat) wait, look, inventory, dodge (if asked), dps (if asked).

>boss
That's not a verb I recognise.

I beg your pardon?

>dps boss
I only understood you as far as wanting to dps.

>dps boss
I only understood you as far as wanting to dps.

* * *

Welcome to Icecrown Citadel, mortal. Status: ALIVE.

MAIN
An Interactive Fiction by Jan Pobi
Release 1 / Serial number 260112 / Inform 7 v10.1.2 / D

ICC Entrance
You are now at the ICC entrance inside the citadel. Next to you is a repair man and infront of you is the next room with enemy units.

You can see an Entrance Teleporter here.

>look
ICC Entrance
You are now at the ICC entrance inside the citadel. Next to you is a repair man and infront of you is the next room with enemy units.

You can see an Entrance Teleporter here.

Available commands: go <direction>, look, inventory, die (debug), repair (if needed).

>die
Open World Graveyard
The cold winds howl. You are at the graveyard outside the raid. You can only return by typing release spirit.

You died. Type release spirit.

>release
ICC Entrance
You stand at the gates of Icecrown Citadel.

You release your spirit and fly back to Icecrown Citadel. Status: ALIVE.

Your equipment is a bit damaged from dying.

You can still die and run back 2 more times before your gear becomes useless.

>look
ICC Entrance
You stand at the gates of Icecrown Citadel.

>north
Trash 1
You can see Trash Pack 1 here.

>north
Boss Room 1
You can see Lord Marrowgar here.

>north
You can't go that way.

>west
Trash 2
You can see Trash Pack 2 here.

>north
Boss Room 2
You can see Lady Deathwhisper here.

>die
Open World Graveyard
The cold winds howl. You are at the graveyard outside the raid. You can only return by typing release spirit.

You died. Type release spirit.

>rel
That's not a verb I recognise.

>release
ICC Entrance
You stand at the gates of Icecrown Citadel.

You release your spirit and fly back to Icecrown Citadel. Status: ALIVE.

Your equipment is a bit damaged from dying.

Careful: you can only die and run back 1 more time before your gear becomes useless.

>die
Open World Graveyard
The cold winds howl. You are at the graveyard outside the raid. You can only return by typing release spirit.

You died. Type release spirit.

>release
ICC Entrance
You stand at the gates of Icecrown Citadel.

You release your spirit and fly back to Icecrown Citadel. Status: ALIVE.

Your equipment is a bit damaged from dying.

Your gear is now basically unusable. You MUST repair before continuing.

I beg your pardon?

>north
Your gear is broken. You must repair at the entrance before moving on.

>repair
You repair your gear. Everything feels solid again.

>look
ICC Entrance
You stand at the gates of Icecrown Citadel.

* * *

>north
Trash 1
You can see Trash Pack 1 here.

>repair
You need a repair NPC. Go back to the raid entrance.

>south
ICC Entrance
You stand at the gates of Icecrown Citadel.

>repair
You repair your gear. Everything feels solid again.

>die
Open World Graveyard
The cold winds howl. You are at the graveyard outside the raid. You can only return by typing release spirit.

You died. Type release spirit.

* * *

>release
ICC Entrance
You stand at the gates of Icecrown Citadel.

You release your spirit and fly back to Icecrown Citadel. Status: ALIVE.

Your equipment is a bit damaged from dying.

You can still die and run back 2 more times before your gear becomes useless.

>repair
You repair your gear. Everything feels solid again.

>north
Trash 1
You can see Trash Pack 1 here.

>die
Open World Graveyard
The cold winds howl. You are at the graveyard outside the raid. You can only return by typing release spirit.

You died. Type release spirit.

* * *

>north
Trash 1
You can see Trash Pack 1 here.

>look
Trash 1
You can see Trash Pack 1 here.

>left
That's not a verb I recognise.

>south
ICC Entrance
You stand at the gates of Icecrown Citadel.

>north
Trash 1
You can see Trash Pack 1 here.

* * *

>die
Open World Graveyard
The cold winds howl. You are at the graveyard outside the raid. You can only return by typing release spirit.

You died. Type release spirit.

>release spirit
ICC Entrance
You stand at the gates of Icecrown Citadel.

You return to Icecrown Citadel. Status: ALIVE.

>k
That's not a verb I recognise.

>release
You are not dead.

>look
ICC Entrance
You stand at the gates of Icecrown Citadel.

>left
That's not a verb I recognise.

>right
That's not a verb I recognise.

>west
You can't go that way.

>repair
That's not a verb I recognise.

* * *

>look
ICC Entrance
You are now at the ICC entrance inside the citadel. Next to you is a repair man and infront of you is the next room with enemy units.

You can see an Entrance Teleporter here.

Available commands: go <direction>, look, inventory, die (debug), repair (if needed).

>inventory
You are carrying nothing.

Available commands: go <direction>, look, inventory, die (debug), repair (if needed).

>repair
You repair your gear. Everything feels solid again.

Available commands: go <direction>, look, inventory, die (debug), repair (if needed).

>n
Trash 1
You can see Trash Pack 1 here.

Available commands: fight, look, inventory, go <direction>.

>look
Trash 1
You can see Trash Pack 1 here.

Available commands: fight, look, inventory, go <direction>.

>fight
You engage the trash pack. The raid moves in!

Trash fight: the raid cleaves through undead...
Trash cleared. You can move on.

Available commands: fight, look, inventory, go <direction>.

* * *

>look
ICC Entrance
You are now at the ICC entrance inside the citadel. Next to you is a repair man and infront of you is the next room with enemy units.

You can see an Entrance Teleporter here.

Available commands: go <direction>, look, inventory, die (debug), repair (if needed).

>n
Trash 1
You can see Trash Pack 1 here.

Available commands: fight, look, inventory, go <direction>.

>die
That's not a verb I recognise.

>dead
That's not a verb I recognise.

* * *

>fight
You engage the trash pack. The raid moves in!

Trash fight: the raid cleaves through undead...
You have successfully cleared the trash mobs. You can move on.

Available commands: fight, look, inventory, go <direction>.

>n
Boss Room 1
You can see Lord Marrowgar here.

Available commands: fight, look, inventory, go <direction>.

* * *

>dps
You burst the bone tombs with heavy DPS!
Lord Marrowgar is defeated! Loot drops: Coldwraith Bracers.
Type loot item to pick it up.

Available commands: fight, look, inventory, go <direction>.

>west
Trash 2
You can see Trash Pack 2 here.

Available commands: fight, look, inventory, go <direction>.

>fight
You engage the trash pack. The raid moves in!

Trash fight: the raid cleaves through undead...
You have successfully cleared the trash mobs. You can move on.

Available commands: fight, look, inventory, go <direction>.

* * *

>n
Boss Room 2
You can see Lady Deathwhisper here.

Available commands: fight, look, inventory, go <direction>.

>pull
You pull Lady Deathwhisper! The boss encounter begins!

Boss fight: Lady Deathwhisper presses the raid...
Lady Deathwhisper uses a raid-wide ability!

Lady Deathwhisper summons adds!Type dps adds to kill them (you have 5 seconds).

Available commands: (in combat) wait, look, inventory, dodge (if asked), dps (if asked).

>dps adds
You obliterate the adds! Now burn the boss shield!
Type dps boss.

Boss fight: Lady Deathwhisper presses the raid...
Lady Deathwhisper uses a raid-wide ability!
A random raider fails a mechanic and takes huge damage!

Available commands: (in combat) wait, look, inventory, dodge (if asked), dps (if asked).

>dps boss
Her shield shatters! Lady Deathwhisper moves to the center!
Type finish boss to follow and kill her.

Boss fight: Lady Deathwhisper presses the raid...
Lady Deathwhisper uses a raid-wide ability!

Boss defeated! Loot drops: Chestguard of the Frigid Noose.
Type loot item to pick it up.

Available commands: fight, look, inventory, go <direction>.

>finish boss
You're not in combat.

Available commands: fight, look, inventory, go <direction>.

* * *

>n
Boss Room 1
You can see Lord Marrowgar here.

Available commands: fight, look, inventory, go <direction>.

>look
Boss Room 1
You can see Lord Marrowgar here.

Available commands: fight, look, inventory, go <direction>.

>fight
You pull Lord Marrowgar! The boss encounter begins!

Lord Marrowgar begins Bone Storm!You have 5 seconds to type DODGE or you die.

Available commands: (in combat) wait, look, inventory, dodge (if asked), dps (if asked).

* * *

>dodge
You DODGE Bone Storm just in time!
Marrowgar follows up with Bone Graveyard - bone tombs trap players!
You have 5 seconds to type DPS.

Available commands: (in combat) wait, look, inventory, dodge (if asked), dps (if asked).

>dps
You burst the bone tombs with heavy DPS!
Lord Marrowgar is defeated! Loot drops: Marrowgar's Scratching Choker.
Type loot item to pick it up.

Available commands: fight, look, inventory, go <direction>.

>look
Boss Room 1
You can see Marrowgar's Scratching Choker and Lord Marrowgar here.

Lord Marrowgar lies defeated on the cold stone.

Available commands: fight, look, inventory, go <direction>.

>loot item
Taken.

Available commands: fight, look, inventory, go <direction>.

>inventory
You are carrying:
  Marrowgar's Scratching Choker

Available commands: fight, look, inventory, go <direction>.

>look
Boss Room 1
You can see Lord Marrowgar here.

Lord Marrowgar lies defeated on the cold stone.

Available commands: fight, look, inventory, go <direction>.

>west
Trash 2
You can see Trash Pack 2 here.

Available commands: fight, look, inventory, go <direction>.

>fight
You engage the trash pack. The raid moves in!

Trash fight: the raid cleaves through undead...
Trash cleared. You can move on.

Available commands: fight, look, inventory, go <direction>.

>north
Boss Room 2
You can see Lady Deathwhisper here.

Available commands: fight, look, inventory, go <direction>.

>look
Boss Room 2
You can see Lady Deathwhisper here.

Available commands: fight, look, inventory, go <direction>.

>fight
You pull Lady Deathwhisper! The boss encounter begins!

Boss fight: Lady Deathwhisper presses the raid...
Lady Deathwhisper uses a raid-wide ability!

Available commands: (in combat) wait, look, inventory, dodge (if asked), dps (if asked).

>dps
No need to DPS here.

Boss fight: Lady Deathwhisper presses the raid...
Lady Deathwhisper uses a raid-wide ability!

Available commands: (in combat) wait, look, inventory, dodge (if asked), dps (if asked).

>dps
No need to DPS here.

Boss fight: Lady Deathwhisper presses the raid...

Boss defeated! Loot drops: Ghoul Commander's Cuirass.
Type loot item to pick it up.

Available commands: fight, look, inventory, go <direction>.

>inventory
You are carrying:
  Marrowgar's Scratching Choker

Available commands: fight, look, inventory, go <direction>.

>look
Boss Room 2
You can see Ghoul Commander's Cuirass and Lady Deathwhisper here.

Lady Deathwhisper lies defeated on the cold stone.

Available commands: fight, look, inventory, go <direction>.

>loot item
Taken.

Available commands: fight, look, inventory, go <direction>.

>inventory
You are carrying:
  Ghoul Commander's Cuirass
  Marrowgar's Scratching Choker

Available commands: fight, look, inventory, go <direction>.

>look
Boss Room 2
You can see Lady Deathwhisper here.

Lady Deathwhisper lies defeated on the cold stone.

Available commands: fight, look, inventory, go <direction>.

>north
Trash 3
You can see Trash Pack 3 here.

Available commands: fight, look, inventory, go <direction>.

>fight
You engage the trash pack. The raid moves in!

Trash fight: the raid cleaves through undead...
Trash cleared. You can move on.

Available commands: fight, look, inventory, go <direction>.

>north
Boss Room 3
You can see Gunship Battle here.

Available commands: fight, look, inventory, go <direction>.

>fight
You pull Gunship Battle! The boss encounter begins!

Boss fight: Gunship Battle presses the raid...

Available commands: (in combat) wait, look, inventory, dodge (if asked), dps (if asked).

>dps
No need to DPS here.

Boss fight: Gunship Battle presses the raid...
A random raider fails a mechanic and takes huge damage!

Available commands: (in combat) wait, look, inventory, dodge (if asked), dps (if asked).

>dšs
That's not a verb I recognise.

>dps
No need to DPS here.

Boss fight: Gunship Battle presses the raid...

Boss defeated! Loot drops: Ice-Reinforced Vrykul Helm.
Type loot item to pick it up.

Available commands: fight, look, inventory, go <direction>.

>inventory
You are carrying:
  Ghoul Commander's Cuirass
  Marrowgar's Scratching Choker

Available commands: fight, look, inventory, go <direction>.

>look
Boss Room 3
You can see Ice-Reinforced Vrykul Helm and Gunship Battle here.

Gunship Battle lies defeated on the cold stone.

Available commands: fight, look, inventory, go <direction>.

>loot item
Taken.

Available commands: fight, look, inventory, go <direction>.

>inventory
You are carrying:
  Ice-Reinforced Vrykul Helm
  Ghoul Commander's Cuirass
  Marrowgar's Scratching Choker

Available commands: fight, look, inventory, go <direction>.

I beg your pardon?

>look
Boss Room 3
You can see Gunship Battle here.

Gunship Battle lies defeated on the cold stone.

Available commands: fight, look, inventory, go <direction>.

>n
Trash 4
You can see Trash Pack 4 here.

Available commands: fight, look, inventory, go <direction>.

>fight
You engage the trash pack. The raid moves in!

Trash fight: the raid cleaves through undead...
Trash cleared. You can move on.

Available commands: fight, look, inventory, go <direction>.

>n
Boss Room 4
You can see Deathbringer Saurfang here.

Available commands: fight, look, inventory, go <direction>.

>fight
You pull Deathbringer Saurfang! The boss encounter begins!

Boss fight: Deathbringer Saurfang presses the raid...
Deathbringer Saurfang uses a raid-wide ability!

Available commands: (in combat) wait, look, inventory, dodge (if asked), dps (if asked).

>dps
No need to DPS here.

Boss fight: Deathbringer Saurfang presses the raid...
Deathbringer Saurfang uses a raid-wide ability!

Available commands: (in combat) wait, look, inventory, dodge (if asked), dps (if asked).

>dps
No need to DPS here.

Boss fight: Deathbringer Saurfang presses the raid...
A random raider fails a mechanic and takes huge damage!

Boss defeated! Loot drops: Ramaladni's Blade of Culling.
Type loot item to pick it up.

Available commands: fight, look, inventory, go <direction>.

>n
You can't go that way.

Available commands: fight, look, inventory, go <direction>.

>east
Trash 5
You can see Trash Pack 5 here.

Available commands: fight, look, inventory, go <direction>.

>fight
You engage the trash pack. The raid moves in!

Trash fight: the raid cleaves through undead...
Trash cleared. You can move on.

Available commands: fight, look, inventory, go <direction>.

>loot item
There's no loot to take.

Available commands: fight, look, inventory, go <direction>.

>south
You can't go that way.

Available commands: fight, look, inventory, go <direction>.

>west
Boss Room 4
You can see Ramaladni's Blade of Culling and Deathbringer Saurfang here.

Deathbringer Saurfang lies defeated on the cold stone.

Available commands: fight, look, inventory, go <direction>.

>loot item
Taken.

Available commands: fight, look, inventory, go <direction>.

>inventory
You are carrying:
  Ramaladni's Blade of Culling
  Ice-Reinforced Vrykul Helm
  Ghoul Commander's Cuirass
  Marrowgar's Scratching Choker

Available commands: fight, look, inventory, go <direction>.

>n
You can't go that way.

Available commands: fight, look, inventory, go <direction>.

>east
Trash 5
You can see Trash Pack 5 here.

The dead Trash Pack 5 lies here. The trash pack is cleared.

Available commands: fight, look, inventory, go <direction>.

>n
You can't go that way.

Available commands: fight, look, inventory, go <direction>.

>east
Boss Room 5
You can see Festergut here.

Available commands: fight, look, inventory, go <direction>.

>fight
You pull Festergut! The boss encounter begins!

Boss fight: Festergut presses the raid...

Available commands: (in combat) wait, look, inventory, dodge (if asked), dps (if asked).

>wait
Time passes.

Boss fight: Festergut presses the raid...
Festergut uses a raid-wide ability!
A random raider fails a mechanic and takes huge damage!

Available commands: (in combat) wait, look, inventory, dodge (if asked), dps (if asked).

>look
Boss Room 5
You can see Festergut here.

Boss fight: Festergut presses the raid...
Festergut uses a raid-wide ability!

Boss defeated! Loot drops: some frost-covered loot.
Type loot item to pick it up.

Available commands: fight, look, inventory, go <direction>.

I beg your pardon?

>west
Trash 6
You can see Trash Pack 6 here.

Available commands: fight, look, inventory, go <direction>.

>fight
You engage the trash pack. The raid moves in!

Trash fight: the raid cleaves through undead...
Trash cleared. You can move on.

Available commands: fight, look, inventory, go <direction>.

>n
Boss Room 6
You can see Rotface here.

Available commands: fight, look, inventory, go <direction>.

>fight
You pull Rotface! The boss encounter begins!

Boss fight: Rotface presses the raid...
Rotface uses a raid-wide ability!

Available commands: (in combat) wait, look, inventory, dodge (if asked), dps (if asked).

>dps
No need to DPS here.

Boss fight: Rotface presses the raid...

Available commands: (in combat) wait, look, inventory, dodge (if asked), dps (if asked).

>dps
No need to DPS here.

Boss fight: Rotface presses the raid...

Boss defeated! Loot drops: some frost-covered loot.
Type loot item to pick it up.

Available commands: fight, look, inventory, go <direction>.

>look
Boss Room 6
You can see some frost-covered loot and Rotface here.

Rotface lies defeated on the cold stone.

Available commands: fight, look, inventory, go <direction>.

>south
Trash 7
You can see Trash Pack 7 here.

Available commands: fight, look, inventory, go <direction>.

>fight
You engage the trash pack. The raid moves in!

Trash fight: the raid cleaves through undead...
Trash cleared. You can move on.

Available commands: fight, look, inventory, go <direction>.

>n
Boss Room 7
You can see Professor Putricide here.

Available commands: fight, look, inventory, go <direction>.

>fight
You pull Professor Putricide! The boss encounter begins!

Boss fight: Professor Putricide presses the raid...

Available commands: (in combat) wait, look, inventory, dodge (if asked), dps (if asked).

>dodge
No need to dodge here.

Boss fight: Professor Putricide presses the raid...
Professor Putricide uses a raid-wide ability!

Available commands: (in combat) wait, look, inventory, dodge (if asked), dps (if asked).

>dps
No need to DPS here.

Boss fight: Professor Putricide presses the raid...
Professor Putricide uses a raid-wide ability!

Boss defeated! Loot drops: some frost-covered loot.
Type loot item to pick it up.

Available commands: fight, look, inventory, go <direction>.

>look
Boss Room 7
You can see some frost-covered loot and Professor Putricide here.

Professor Putricide lies defeated on the cold stone.

Available commands: fight, look, inventory, go <direction>.

>n
Trash 8
You can see Trash Pack 8 here.

Available commands: fight, look, inventory, go <direction>.

>fight
You engage the trash pack. The raid moves in!

Trash fight: the raid cleaves through undead...
Trash cleared. You can move on.

Available commands: fight, look, inventory, go <direction>.

>n
Boss Room 8
You can see Blood Prince Council here.

Available commands: fight, look, inventory, go <direction>.

>fight
You pull Blood Prince Council! The boss encounter begins!

Boss fight: Blood Prince Council presses the raid...
Blood Prince Council uses a raid-wide ability!

Available commands: (in combat) wait, look, inventory, dodge (if asked), dps (if asked).

>dps
No need to DPS here.

Boss fight: Blood Prince Council presses the raid...

Available commands: (in combat) wait, look, inventory, dodge (if asked), dps (if asked).

>dodge
No need to dodge here.

Boss fight: Blood Prince Council presses the raid...
Blood Prince Council uses a raid-wide ability!

Boss defeated! Loot drops: some frost-covered loot.
Type loot item to pick it up.

Available commands: fight, look, inventory, go <direction>.

>west
You can't go that way.

Available commands: fight, look, inventory, go <direction>.

>n
You can't go that way.

Available commands: fight, look, inventory, go <direction>.

>south
Trash 8
You can see Trash Pack 8 here.

The dead Trash Pack 8 lies here. The trash pack is cleared.

Available commands: fight, look, inventory, go <direction>.

>north
Boss Room 8
You can see some frost-covered loot and Blood Prince Council here.

Blood Prince Council lies defeated on the cold stone.

Available commands: fight, look, inventory, go <direction>.

>north
You can't go that way.

Available commands: fight, look, inventory, go <direction>.

>east
Trash 9
You can see Trash Pack 9 here.

Available commands: fight, look, inventory, go <direction>.

>fight
You engage the trash pack. The raid moves in!

Trash fight: the raid cleaves through undead...
Trash cleared. You can move on.

Available commands: fight, look, inventory, go <direction>.

>n
Boss Room 9
You can see Blood-Queen Lana'thel here.

Available commands: fight, look, inventory, go <direction>.

>fight
You pull Blood-Queen Lana'thel! The boss encounter begins!

Boss fight: Blood-Queen Lana'thel presses the raid...
Blood-Queen Lana'thel uses a raid-wide ability!
A random raider fails a mechanic and takes huge damage!

Available commands: (in combat) wait, look, inventory, dodge (if asked), dps (if asked).

>dps
No need to DPS here.

Boss fight: Blood-Queen Lana'thel presses the raid...

Available commands: (in combat) wait, look, inventory, dodge (if asked), dps (if asked).

>dps
No need to DPS here.

Boss fight: Blood-Queen Lana'thel presses the raid...
Blood-Queen Lana'thel uses a raid-wide ability!

Boss defeated! Loot drops: some frost-covered loot.
Type loot item to pick it up.

Available commands: fight, look, inventory, go <direction>.

>n
Trash 10
You can see Trash Pack 10 here.

Available commands: fight, look, inventory, go <direction>.

>fight
You engage the trash pack. The raid moves in!

Trash fight: the raid cleaves through undead...
Trash cleared. You can move on.

Available commands: fight, look, inventory, go <direction>.

>n
Boss Room 10
You can see Valithria Dreamwalker here.

Available commands: fight, look, inventory, go <direction>.

>dps
There's nothing to DPS right now.

Available commands: fight, look, inventory, go <direction>.

>fight
You pull Valithria Dreamwalker! The boss encounter begins!

Boss fight: Valithria Dreamwalker presses the raid...

Available commands: (in combat) wait, look, inventory, dodge (if asked), dps (if asked).

>dps
No need to DPS here.

Boss fight: Valithria Dreamwalker presses the raid...

Available commands: (in combat) wait, look, inventory, dodge (if asked), dps (if asked).

>dps
No need to DPS here.

Boss fight: Valithria Dreamwalker presses the raid...
Valithria Dreamwalker uses a raid-wide ability!

Boss defeated! Loot drops: some frost-covered loot.
Type loot item to pick it up.

Available commands: fight, look, inventory, go <direction>.

>n
You can't go that way.

Available commands: fight, look, inventory, go <direction>.

>west
You can't go that way.

Available commands: fight, look, inventory, go <direction>.

>east
You can't go that way.

Available commands: fight, look, inventory, go <direction>.

>south
Trash 11
You can see Trash Pack 11 here.

Available commands: fight, look, inventory, go <direction>.

>fight
You engage the trash pack. The raid moves in!

Trash fight: the raid cleaves through undead...
Trash cleared. You can move on.

Available commands: fight, look, inventory, go <direction>.

>n
Boss Room 11
You can see Sindragosa here.

Available commands: fight, look, inventory, go <direction>.

>fight
You pull Sindragosa! The boss encounter begins!

Boss fight: Sindragosa presses the raid...
Sindragosa uses a raid-wide ability!

Available commands: (in combat) wait, look, inventory, dodge (if asked), dps (if asked).

>dps
No need to DPS here.

Boss fight: Sindragosa presses the raid...

Available commands: (in combat) wait, look, inventory, dodge (if asked), dps (if asked).

>dodge
No need to dodge here.

Boss fight: Sindragosa presses the raid...
Sindragosa uses a raid-wide ability!
A random raider fails a mechanic and takes huge damage!

Boss defeated! Loot drops: some frost-covered loot.
Type loot item to pick it up.

Available commands: fight, look, inventory, go <direction>.

>n
You can't go that way.

Available commands: fight, look, inventory, go <direction>.

* * *

>east
You can't go that way.

Available commands: fight, look, inventory, go <direction>.

>nort
That's not a verb I recognise.

>south
Trash 12
You can see Trash Pack 12 here.

Available commands: fight, look, inventory, go <direction>.

>fight
You engage the trash pack. The raid moves in!

Trash fight: the raid cleaves through undead...
Trash cleared. You can move on.

Available commands: fight, look, inventory, go <direction>.

>n
Boss Room 12
You can see a Lich King here.

Available commands: fight, look, inventory, go <direction>.

>look
Boss Room 12
You can see a Lich King here.

Available commands: fight, look, inventory, go <direction>.

>fi
That's not a verb I recognise.

>fight
You pull the Lich King! The boss encounter begins!

Boss fight: The Lich King presses the raid...

Available commands: (in combat) wait, look, inventory, dodge (if asked), dps (if asked).

>dps
No need to DPS here.

Boss fight: The Lich King presses the raid...
The Lich King uses a raid-wide ability!

Available commands: (in combat) wait, look, inventory, dodge (if asked), dps (if asked).

>dps
No need to DPS here.

Boss fight: The Lich King presses the raid...
A random raider fails a mechanic and takes huge damage!

Boss defeated! Loot drops: some frost-covered loot.
Type loot item to pick it up.

Available commands: fight, look, inventory, go <direction>.

>loot item
Taken.

Available commands: fight, look, inventory, go <direction>.

>look
Boss Room 12
You can see a Lich King here.

The Lich King lies defeated on the cold stone.

Available commands: fight, look, inventory, go <direction>.

>n
You can't go that way.

Available commands: fight, look, inventory, go <direction>.

>w
You can't go that way.

Available commands: fight, look, inventory, go <direction>.

>e
You can't go that way.

Available commands: fight, look, inventory, go <direction>.

>s
Trash 12
You can see Trash Pack 12 here.

The dead Trash Pack 12 lies here. The trash pack is cleared.

Available commands: fight, look, inventory, go <direction>.

>n
Boss Room 12
You can see a Lich King here.

The Lich King lies defeated on the cold stone.

Available commands: fight, look, inventory, go <direction>.

>inventory
You are carrying:
  some frost-covered loot
  Ramaladni's Blade of Culling
  Ice-Reinforced Vrykul Helm
  Ghoul Commander's Cuirass
  Marrowgar's Scratching Choker

Available commands: fight, look, inventory, go <direction>.

* * *

>look
ICC Entrance
You are now at the ICC entrance inside the citadel. Next to you is a repair man and infront of you is the next room with enemy units.

You can see an Entrance Teleporter here.

Available commands: go <direction>, look, inventory, die (debug), repair (if needed).

>north
Trash 1
You can see Trash Pack 1 here.

Available commands: fight, look, inventory, go <direction>.

>attack
(Trash Pack 1)
Violence isn't the answer to this one.

>look
Trash 1
You can see Trash Pack 1 here.

>n
Boss Room 1
You can see Boss One here.

>n
You can't go that way.

>look
Boss Room 1
You can see Boss One here.

* * *

>north
Trash 1
You can see Trash Pack 1 here.

Available commands: fight, look, inventory, go <direction>.

>fight
You engage the trash pack. The raid moves in!

Trash fight: the raid cleaves through undead...
Trash cleared. You can move on.

Available commands: fight, look, inventory, go <direction>.

>look
Trash 1
You can see Trash Pack 1 here.

The dead Trash Pack 1 lies here. The trash pack is cleared.

Available commands: fight, look, inventory, go <direction>.

>north
Boss Room 1
You can see Lord Marrowgar here.

Available commands: fight, look, inventory, go <direction>.

>south
Trash 1
You can see Trash Pack 1 here.

The dead Trash Pack 1 lies here. The trash pack is cleared.

Available commands: fight, look, inventory, go <direction>.

>north
Boss Room 1
You can see Lord Marrowgar here.

Available commands: fight, look, inventory, go <direction>.

>inventory
You are carrying nothing.

Available commands: fight, look, inventory, go <direction>.

>fight
You pull Lord Marrowgar! The boss encounter begins!

Lord Marrowgar begins Bone Storm!You have 10 seconds to type DODGE or you die.

Available commands: (in combat) wait, look, inventory, dodge (if asked), dps (if asked).

>dodge
You DODGE Bone Storm just in time!
Marrowgar follows up with Bone Graveyard - bone tombs trap players!
You have 10 seconds to type DPS.

Available commands: (in combat) wait, look, inventory, dodge (if asked), dps (if asked).

>dps
You burst the bone tombs with heavy DPS!
Lord Marrowgar is defeated! Loot drops: Marrowgar's Scratching Choker.
Type loot item to pick it up.

Available commands: fight, look, inventory, go <direction>.

>loot item
Taken.

Available commands: fight, look, inventory, go <direction>.

>inventory
You are carrying:
  a Marrowgar's Scratching Choker

Available commands: fight, look, inventory, go <direction>.

>look
Boss Room 1
You can see Lord Marrowgar here.

Lord Marrowgar lies defeated on the cold stone.

Available commands: fight, look, inventory, go <direction>.

>south
Trash 1
You can see Trash Pack 1 here.

The dead Trash Pack 1 lies here. The trash pack is cleared.

Available commands: fight, look, inventory, go <direction>.

>north
Boss Room 1
You can see Lord Marrowgar here.

Lord Marrowgar lies defeated on the cold stone.

Available commands: fight, look, inventory, go <direction>.

>west
Trash 2
You can see Trash Pack 2 here.

Available commands: fight, look, inventory, go <direction>.

* * *

>north
Boss Room 2
You can see Lady Deathwhisper here.

Available commands: fight, look, inventory, go <direction>.

>south
Trash 2
You can see Trash Pack 2 here.

The dead Trash Pack 2 lies here. The trash pack is cleared.

Available commands: fight, look, inventory, go <direction>.

>north
Boss Room 2
You can see Lady Deathwhisper here.

Available commands: fight, look, inventory, go <direction>.

>fight
You pull Lady Deathwhisper! The boss encounter begins!

Boss fight: Lady Deathwhisper presses the raid...

Available commands: (in combat) wait, look, inventory, dodge (if asked), dps (if asked).

>look
Boss Room 2
You can see Lady Deathwhisper here.

Boss fight: Lady Deathwhisper presses the raid...
Lady Deathwhisper uses a raid-wide ability!

Available commands: (in combat) wait, look, inventory, dodge (if asked), dps (if asked).

>dps
No need to DPS here.

Boss fight: Lady Deathwhisper presses the raid...

Boss defeated! Loot drops: Deathspeaker Zealot's Helm.
Type loot item to pick it up.

Available commands: fight, look, inventory, go <direction>.

>loot item
Taken.

Available commands: fight, look, inventory, go <direction>.

>inventory
You are carrying:
  a Deathspeaker Zealot's Helm

Available commands: fight, look, inventory, go <direction>.

>look
Boss Room 2
You can see Lady Deathwhisper here.

Lady Deathwhisper lies defeated on the cold stone.

Available commands: fight, look, inventory, go <direction>.

* * *

>north
Trash 1
You can see Trash Pack 1 here.

Available commands: fight, look, inventory, go <direction>.

>north
Trash blocks the way. Type fight to clear it.

Available commands: fight, look, inventory, go <direction>.

>south
ICC Entrance
You stand at the gates of Icecrown Citadel.

Available commands: go <direction>, look, inventory, die (debug), repair (if needed).

>north
Trash 1
You can see Trash Pack 1 here.

Available commands: fight, look, inventory, go <direction>.

>fight
You engage the trash pack. The raid moves in!

Trash fight: the raid cleaves through undead...
Trash cleared. You can move on.

Available commands: Trash is cleared. go <direction>, look, inventory.

* * *

>north
Lord Marrowgar blocks the way. Type fight to start the encounter.

Available commands: fight, look, inventory, go <direction>.

>south
Trash 1
You can see Trash Pack 1 here.

Available commands: Trash is cleared. go <direction>, look, inventory.

>north
Boss Room 1
You can see Lord Marrowgar here.

Available commands: fight, look, inventory, go <direction>.

>look
Boss Room 1
You can see Lord Marrowgar here.

Available commands: fight, look, inventory, go <direction>.

>fight
You pull Lord Marrowgar! The boss encounter begins!

Boss fight: the encounter is underway...
Someone stands in bad stuff. Healer screams in chat.

Available commands: (in combat) wait, look, inventory, die (debug).

>look
Boss Room 1
You can see Lord Marrowgar here.

Boss fight: the encounter is underway...
Lord Marrowgar uses a raid-wide ability!

Available commands: (in combat) wait, look, inventory, die (debug).

>look
Boss Room 1
You can see Lord Marrowgar here.

Boss fight: the encounter is underway...
Lord Marrowgar uses a raid-wide ability!

Available commands: (in combat) wait, look, inventory, die (debug).

>look
Boss Room 1
You can see Lord Marrowgar here.

Boss fight: the encounter is underway...
Someone stands in bad stuff. Healer screams in chat.

Available commands: (in combat) wait, look, inventory, die (debug).

>look
Boss Room 1
You can see Lord Marrowgar here.

Boss fight: the encounter is underway...

Available commands: (in combat) wait, look, inventory, die (debug).

>look
Boss Room 1
You can see Lord Marrowgar here.

Boss fight: the encounter is underway...
Someone stands in bad stuff. Healer screams in chat.
Lord Marrowgar uses a raid-wide ability!

Available commands: (in combat) wait, look, inventory, die (debug).

>wait
Time passes.

Boss fight: the encounter is underway...

Available commands: (in combat) wait, look, inventory, die (debug).

>look
Boss Room 1
You can see Lord Marrowgar here.

Boss fight: the encounter is underway...
A random raider fails a mechanic and takes huge damage!
Lord Marrowgar uses a raid-wide ability!

Available commands: (in combat) wait, look, inventory, die (debug).

>north
Lord Marrowgar blocks the way. Type fight to start the encounter.

Boss fight: the encounter is underway...
Someone stands in bad stuff. Healer screams in chat.
Lord Marrowgar uses a raid-wide ability!

Available commands: (in combat) wait, look, inventory, die (debug).

>north
Lord Marrowgar blocks the way. Type fight to start the encounter.

Boss fight: the encounter is underway...

Available commands: (in combat) wait, look, inventory, die (debug).

>look
Boss Room 1
You can see Lord Marrowgar here.

Boss fight: the encounter is underway...
A random raider fails a mechanic and takes huge damage!

Available commands: (in combat) wait, look, inventory, die (debug).

>look
Boss Room 1
You can see Lord Marrowgar here.

Boss fight: the encounter is underway...
Lord Marrowgar uses a raid-wide ability!

Available commands: (in combat) wait, look, inventory, die (debug).

* * *

>look
ICC Entrance
You are now at the ICC entrance inside the citadel. Next to you is a repair man and infront of you is the next room with enemy units.

You can see an Entrance Teleporter here.

Available commands: go <direction>, look, inventory, die (debug), repair (if needed).

>repair
You repair your gear. Everything feels solid again.

Available commands: go <direction>, look, inventory, die (debug), repair (if needed).

>north
Trash 1
You can see Trash Pack 1 here.

Available commands: fight, look, inventory, go <direction>.

* * *

>fight
You engage the trash pack. The raid moves in!

Trash fight: the raid cleaves through undead...
Trash cleared. You can move on.

Available commands: fight, look, inventory, go <direction>.

>look
Trash 1
You can see Trash Pack 1 here.

Available commands: fight, look, inventory, go <direction>.

>north
Boss Room 1
You can see Lord Marrowgar here.

Available commands: fight, look, inventory, go <direction>.

* * *

>north
Lord Marrowgar blocks the way. Type fight to start the encounter.

Available commands: fight, look, inventory, go <direction>.

>fight
You pull Lord Marrowgar! The boss encounter begins!

Lord Marrowgar begins Bone Storm!You have 10 seconds to type DODGE or you die.

Available commands: (in combat) wait, look, inventory, dodge (if asked), dps (if asked).

I beg your pardon?

>look
Boss Room 1
You can see Lord Marrowgar here.

You fail to dodge Bone Storm. It's a massacre.

Open World Graveyard
The cold winds howl. You are at the graveyard outside the raid. You can only return by typing release spirit.

You died. Type release spirit.

I beg your pardon?

>north
You are dead. Only release spirit works now.

>release
ICC Entrance
You stand at the gates of Icecrown Citadel.

You release your spirit and fly back to Icecrown Citadel. Status: ALIVE.

Your equipment is a bit damaged from dying.

You can still die and run back 2 more times before your gear becomes useless.

Available commands: go <direction>, look, inventory, die (debug), repair (if needed).

>look
ICC Entrance
You stand at the gates of Icecrown Citadel.

Available commands: go <direction>, look, inventory, die (debug), repair (if needed).

>north
Trash 1
You can see Trash Pack 1 here.

Available commands: fight, look, inventory, go <direction>.

>north
Boss Room 1
You can see Lord Marrowgar here.

Available commands: fight, look, inventory, go <direction>.

>fight
You pull Lord Marrowgar! The boss encounter begins!

Lord Marrowgar begins Bone Storm!You have 10 seconds to type DODGE or you die.

Available commands: (in combat) wait, look, inventory, dodge (if asked), dps (if asked).

* * *

>dodge
You DODGE Bone Storm just in time!
Marrowgar follows up with Bone Graveyard - bone tombs trap players!
You have 10 seconds to type DPS.

Available commands: (in combat) wait, look, inventory, dodge (if asked), dps (if asked).

>dps
You burst the bone tombs with heavy DPS!
Lord Marrowgar is defeated! Loot drops: Marrowgar's Scratching Choker.

Available commands: fight, look, inventory, go <direction>.

>look
Boss Room 1
You can see Lord Marrowgar here.

Available commands: fight, look, inventory, go <direction>.

>north
You can't go that way.

Available commands: fight, look, inventory, go <direction>.

>west
Trash 2
You can see Trash Pack 2 here.

Available commands: fight, look, inventory, go <direction>.

* * *

>north
Boss Room 2
You can see Lady Deathwhisper here.

Available commands: fight, look, inventory, go <direction>.

>north
Lady Deathwhisper blocks the way. Type fight to start the encounter.

Available commands: fight, look, inventory, go <direction>.

>fight
You pull Lady Deathwhisper! The boss encounter begins!

Boss fight: Lady Deathwhisper presses the raid...
Lady Deathwhisper uses a raid-wide ability!

Available commands: (in combat) wait, look, inventory, dodge (if asked), dps (if asked).

>dps
No need to DPS here.

Boss fight: Lady Deathwhisper presses the raid...
Lady Deathwhisper uses a raid-wide ability!
A random raider fails a mechanic and takes huge damage!

Available commands: (in combat) wait, look, inventory, dodge (if asked), dps (if asked).

>look
Boss Room 2
You can see Lady Deathwhisper here.

Boss fight: Lady Deathwhisper presses the raid...

Boss defeated! Loot drops: Ghoul Commander's Cuirass.

Available commands: fight, look, inventory, go <direction>.

>look
Boss Room 2
You can see Lady Deathwhisper here.

Available commands: fight, look, inventory, go <direction>.

>north
Trash 3
You can see Trash Pack 3 here.

Available commands: fight, look, inventory, go <direction>.

>inventory
You are carrying nothing.

Available commands: fight, look, inventory, go <direction>.

* * *

>look
ICC Entrance
You are now at the ICC entrance inside the citadel. Next to you is a repair man and infront of you is the next room with enemy units.

You can see an Entrance Teleporter here.

Available commands: go <direction>, look, inventory, die (debug), repair (if needed).

>teleport
Teleport destinations (Trash before each boss):
 - 1: Trash 1
 - 2: (locked)
 - 3: (locked)
 - 4: (locked)
 - 5: (locked)
 - 6: (locked)
 - 7: (locked)
 - 8: (locked)
 - 9: (locked)
 - 10: (locked)
 - 11: (locked)
 - 12: (locked)

Use: teleport to <number>.

Available commands: go <direction>, look, inventory, die (debug), repair (if needed).

>look
ICC Entrance
You are now at the ICC entrance inside the citadel. Next to you is a repair man and infront of you is the next room with enemy units.

You can see an Entrance Teleporter here.

Available commands: go <direction>, look, inventory, die (debug), repair (if needed).

>teleport 12
I only understood you as far as wanting to teleport.

>teleport 1
I only understood you as far as wanting to teleport.

>teeleport to 12
That's not a verb I recognise.

>teleport to 12
That destination is locked. Defeat previous bosses to unlock it.

Available commands: go <direction>, look, inventory, die (debug), repair (if needed).

>teleport to 1
Trash 1
You can see Trash Pack 1 here.

You step onto the teleporter... icy magic pulls you through space!

You arrive at the Trash 1, before Boss 1.

Available commands: fight, look, inventory, go <direction>.

>look
Trash 1
You can see Trash Pack 1 here.

Available commands: fight, look, inventory, go <direction>.

* * *

>look
ICC Entrance
You are now at the ICC entrance inside the citadel. Next to you is a repair man and infront of you is the next room with enemy units.

You can see an Entrance Teleporter here.

Available commands: go <direction>, look, inventory, die (debug), repair (if needed).

>teleporter
Teleport destinations:
 - 1: Boss Room 1
 - 2: Boss Room 2
 - 3: Boss Room 3
 - 4: Boss Room 4
 - 5: Boss Room 5
 - 6: Boss Room 6
 - 7: Boss Room 7
 - 8: Boss Room 8
 - 9: Boss Room 9
 - 10: Boss Room 10
 - 11: Boss Room 11
 - 12: Boss Room 12

Use: teleport to <number>.

Available commands: go <direction>, look, inventory, die (debug), repair (if needed).

>teleport 12
I only understood you as far as wanting to teleport.

>teleport to 12
Boss Room 12
You can see a Lich King here.

You step into the teleporter... Destination reached.
Boss Room 12
You can see a Lich King here.

Available commands: fight, look, inventory, go <direction>.

>look
Boss Room 12
You can see a Lich King here.

Available commands: fight, look, inventory, go <direction>.

>fight
You pull the Lich King! The boss encounter begins!

The Lich King begins!He swings with Soul Reaper! Survive it!
Type use defensive (you have 5 seconds).

Available commands: (in combat) wait, look, inventory, dodge (if asked), dps (if asked).

>use defensive
You pop a defensive and survive Soul Reaper!
Now punish him - type dps boss.

Available commands: (in combat) wait, look, inventory, dodge (if asked), dps (if asked).

>dps boss
No boss to DPS here.

Available commands: (in combat) wait, look, inventory, dodge (if asked), dps (if asked).

>dps
Too late! You fail to punish him and the raid collapses.

Open World Graveyard
You are at the graveyard outside the raid because you are DEAD. The cold winds howls. Other spirits are whispering to you. Do not listen to them. Go to the light. You can only return by typing release spirit.

You died. Type release spirit.

* * *

Welcome to Icecrown Citadel, mortal. Status: ALIVE.

MAIN
An Interactive Fiction by Jan Pobi
Release 1 / Serial number 260112 / Inform 7 v10.1.2 / D

ICC Entrance
You are now at the ICC entrance inside the citadel. Next to you is a repair man and infront of you is the next room with enemy units.

You can see an Entrance Teleporter here.

>n
Trash 1
You can see Trash Pack 1 here.

Available commands: fight, look, inventory, go <direction>.

>f
That's not a verb I recognise.

>fight
You engage the trash pack. The raid moves in!

Trash fight: the raid cleaves through undead...
You have successfully cleared the trash mobs. You can move on.

Available commands: fight, look, inventory, go <direction>.

* * *

>n
Boss Room 1
You can see Lord Marrowgar here.

Available commands: fight, look, inventory, go <direction>.

>f
That's not a verb I recognise.

>fight
You pull Lord Marrowgar! The boss encounter begins!

Lord Marrowgar begins Bone Storm!You have 10 seconds to type DODGE or you die.

Available commands: (in combat) wait, look, inventory, dodge (if asked), dps (if asked).

* * *

>dodge
You DODGE Bone Storm just in time!
Marrowgar follows up with Bone Graveyard - bone tombs trap players!
You have 10 seconds to type DPS.

Available commands: (in combat) wait, look, inventory, dodge (if asked), dps (if asked).

>dps
You burst the bone tombs with heavy DPS!
Lord Marrowgar is defeated! Loot drops: Shawl of Nerubian Silk.
Type loot item to pick it up.

Available commands: fight, look, inventory, go <direction>.

>loot item
Taken.

Available commands: fight, look, inventory, go <direction>.

>inventory
You are carrying:
  a Shawl of Nerubian Silk

Available commands: fight, look, inventory, go <direction>.

>west
Trash 2
You can see Trash Pack 2 here.

Available commands: fight, look, inventory, go <direction>.

>inventory
You are carrying:
  a Shawl of Nerubian Silk

Available commands: fight, look, inventory, go <direction>.

>fight
You engage the trash pack. The raid moves in!

Trash fight: the raid cleaves through undead...
Trash cleared. You can move on.

Available commands: fight, look, inventory, go <direction>.

* * *

>north
Boss Room 2
You can see Lady Deathwhisper here.

Available commands: fight, look, inventory, go <direction>.

>fight
You pull Lady Deathwhisper! The boss encounter begins!

Boss fight: Lady Deathwhisper presses the raid...
Lady Deathwhisper uses a raid-wide ability!

Available commands: (in combat) wait, look, inventory, dodge (if asked), dps (if asked).

>dodge
No need to dodge here.

Boss fight: Lady Deathwhisper presses the raid...

Available commands: (in combat) wait, look, inventory, dodge (if asked), dps (if asked).

>dps
No need to DPS here.

Boss fight: Lady Deathwhisper presses the raid...
Lady Deathwhisper uses a raid-wide ability!
A random raider fails a mechanic and takes huge damage!

Boss defeated! Loot drops: Chestguard of the Frigid Noose.
Type loot item to pick it up.

Available commands: fight, look, inventory, go <direction>.

>inventory
You are carrying nothing.

Available commands: fight, look, inventory, go <direction>.

* * *

>dps
You burst the bone tombs with heavy DPS!
Lord Marrowgar is defeated! Loot drops: Marrowgar's Scratching Choker.
Type loot item to pick it up.

Available commands: fight, look, inventory, go <direction>.

>w
Trash 2
You can see Trash Pack 2 here.

Available commands: fight, look, inventory, go <direction>.

* * *

>dps adds
You obliterate the adds! Now burn the boss shield!
Type dps boss.

Available commands: (in combat) wait, look, inventory, dodge (if asked), dps (if asked).

>dps boss
Her shield shatters! Lady Deathwhisper moves to the center!
Type finish boss to follow and kill her.

Available commands: (in combat) wait, look, inventory, dodge (if asked), dps (if asked).

>finish boss
Lady Deathwhisper is defeated!Loot drops: Ghoul Commander's Cuirass.
Type loot item to pick it up.

Available commands: fight, look, inventory, go <direction>.

>n
Trash 3
You can see Trash Pack 3 here.

Available commands: fight, look, inventory, go <direction>.

>fight
You engage the trash pack. The raid moves in!

Trash fight: the raid cleaves through undead...
You have successfully cleared the trash mobs. You can move on.

Available commands: fight, look, inventory, go <direction>.

>n
Boss Room 3
You can see Gunship Battle here.

Available commands: fight, look, inventory, go <direction>.

>fight
You pull Gunship Battle! The boss encounter begins!

Gunship Battle begins!To board the enemy ship, you must equip rocket.
Type equip rocket (you have 5 seconds).

Available commands: (in combat) wait, look, inventory, dodge (if asked), dps (if asked).

>equip rocket
You equip the rocket pack. Jump to the enemy ship!
Type board ship.

Available commands: (in combat) wait, look, inventory, dodge (if asked), dps (if asked).

>board ship
You rocket-jump onto the enemy ship!
A mage is freezing your cannons. Kill him!
Type dps mage.

Available commands: (in combat) wait, look, inventory, dodge (if asked), dps (if asked).

>dps mage
Mage down! Cannons unfreeze!
Now return to your ship.
Type jump back.

Available commands: (in combat) wait, look, inventory, dodge (if asked), dps (if asked).

>jump back
You jump back to your ship!
New enemy adds board your deck!
Type dps adds.

Available commands: (in combat) wait, look, inventory, dodge (if asked), dps (if asked).

>dps adds
Gunship Battle is defeated!Loot drops: Ice-Reinforced Vrykul Helm.
Type loot item to pick it up.

Available commands: fight, look, inventory, go <direction>.

>fight
This boss is already defeated.

Available commands: fight, look, inventory, go <direction>.

>look
Boss Room 3
You can see Ice-Reinforced Vrykul Helm and Gunship Battle here.

Gunship Battle lies defeated on the cold stone.

Available commands: fight, look, inventory, go <direction>.

>n
Trash 4
You can see Trash Pack 4 here.

Available commands: fight, look, inventory, go <direction>.

>fight
You engage the trash pack. The raid moves in!

Trash fight: the raid cleaves through undead...
You have successfully cleared the trash mobs. You can move on.

Available commands: fight, look, inventory, go <direction>.

>n
Boss Room 4
You can see Deathbringer Saurfang here.

Available commands: fight, look, inventory, go <direction>.

>fight
You pull Deathbringer Saurfang! The boss encounter begins!

Available commands: (in combat) wait, look, inventory, dodge (if asked), dps (if asked).

>dps
No need to DPS here.

Available commands: (in combat) wait, look, inventory, dodge (if asked), dps (if asked).

>look
Boss Room 4
You can see Deathbringer Saurfang here.

Available commands: (in combat) wait, look, inventory, dodge (if asked), dps (if asked).

>s
You can't leave now - the boss fight is in progress!

Available commands: (in combat) wait, look, inventory, dodge (if asked), dps (if asked).

>exit
But you aren't in anything at the moment.

Available commands: (in combat) wait, look, inventory, dodge (if asked), dps (if asked).

>die
Open World Graveyard
You are at the graveyard outside the raid because you are DEAD. The cold winds howls. Other spirits are whispering to you. Do not listen to them. Go to the light. You can only return by typing release spirit.

You died. Type release spirit.

>release
ICC Entrance
You are now at the ICC entrance inside the citadel. Next to you is a repair man and infront of you is the next room with enemy units.

You release your spirit and fly back to Icecrown Citadel. Status: ALIVE.

Your equipment is a bit damaged from dying.

You can still die and run back 2 more times before your gear becomes useless.

Available commands: (in combat) wait, look, inventory, dodge (if asked), dps (if asked).

>repair
You repair your gear. Everything feels solid again.

Available commands: (in combat) wait, look, inventory, dodge (if asked), dps (if asked).

* * *

>fight
You pull Lord Marrowgar! The boss encounter begins!

Lord Marrowgar begins Bone Storm!You have 5 seconds to type DODGE or you die.

Available commands: (in combat) wait, look, inventory, dodge (if asked), dps (if asked).

>look
Boss Room 1
You can see Lord Marrowgar here.

Available commands: (in combat) wait, look, inventory, dodge (if asked), dps (if asked).

>dodge
Too late! Bone Storm already hits you.

Open World Graveyard
You are at the graveyard outside the raid because you are DEAD. The cold winds howls. Other spirits are whispering to you. Do not listen to them. Go to the light. You can only return by typing release spirit.

You died. Type release spirit.

>release
ICC Entrance
You are now at the ICC entrance inside the citadel. Next to you is a repair man and infront of you is the next room with enemy units.

You release your spirit and fly back to Icecrown Citadel. Status: ALIVE.

Your equipment is a bit damaged from dying.

You can still die and run back 2 more times before your gear becomes useless.

Available commands: go <direction>, look, inventory, die (debug), repair (if needed).

>n
Trash 1
You can see Trash Pack 1 here.

The dead Trash Pack 1 lies here. The trash pack is cleared.

Available commands: fight, look, inventory, go <direction>.

>n
Boss Room 1
You can see Lord Marrowgar here.

Available commands: fight, look, inventory, go <direction>.

* * *

>dodge
You DODGE Bone Storm just in time!
Marrowgar follows up with Bone Graveyard - bone tombs trap players!
You have 5 seconds to type DPS.

Available commands: (in combat) wait, look, inventory, dodge (if asked), dps (if asked).

>look
Boss Room 1
You can see Lord Marrowgar here.

Available commands: (in combat) wait, look, inventory, dodge (if asked), dps (if asked).

>dps
Too late! The Bone Graveyard tombs weren't destroyed in time.

Open World Graveyard
You are at the graveyard outside the raid because you are DEAD. The cold winds howls. Other spirits are whispering to you. Do not listen to them. Go to the light. You can only return by typing release spirit.

You died. Type release spirit.

>release
ICC Entrance
You are now at the ICC entrance inside the citadel. Next to you is a repair man and infront of you is the next room with enemy units.

You release your spirit and fly back to Icecrown Citadel. Status: ALIVE.

Your equipment is a bit damaged from dying.

Careful: you can only die and run back 1 more time before your gear becomes useless.

Available commands: go <direction>, look, inventory, die (debug), repair (if needed).

>repair
You repair your gear. Everything feels solid again.

Available commands: go <direction>, look, inventory, die (debug), repair (if needed).

>n
Trash 1
You can see Trash Pack 1 here.

The dead Trash Pack 1 lies here. The trash pack is cleared.

Available commands: fight, look, inventory, go <direction>.

* * *

>dodge
You DODGE Bone Storm just in time!
Marrowgar follows up with Bone Graveyard - bone tombs trap players!
You have 5 seconds to type DPS.

Available commands: (in combat) wait, look, inventory, dodge (if asked), dps (if asked).

>dps
You burst the bone tombs with heavy DPS!
Lord Marrowgar is defeated! Loot drops: Shawl of Nerubian Silk.
Type loot item to pick it up.

Available commands: fight, look, inventory, go <direction>.

>west
Trash 2
You can see Trash Pack 2 here.

Available commands: fight, look, inventory, go <direction>.

* * *

>dodge
You DODGE Bone Storm just in time!
Marrowgar follows up with Bone Graveyard - bone tombs trap players!
You have 5 seconds to type DPS.

Available commands: (in combat) wait, look, inventory, dodge (if asked), dps (if asked).

>dps
You burst the bone tombs with heavy DPS!
Lord Marrowgar is defeated!
 Loot drops: Coldwraith Bracers.
Type loot item to pick it up.

Available commands: fight, look, inventory, go <direction>.

>look
Boss Room 1
You can see Marrowgar's Scratching Choker and Lord Marrowgar here.

Lord Marrowgar lies defeated on the cold stone.

Available commands: fight, look, inventory, go <direction>.

>inventory
You are carrying nothing.

Available commands: fight, look, inventory, go <direction>.

>loot item
Taken.

Available commands: fight, look, inventory, go <direction>.

>restart
Are you sure you want to restart?

>yes
Icecrown Citadel raid start. Status: ALIVE.

MAIN
An Interactive Fiction by Jan Pobi
Release 1 / Serial number 260108 / Inform 7 v10.1.2 / D

ICC Entrance
You are now at the ICC entrance inside the citadel. Next to you is a repair man and infront of you is the next room with enemy units.

>n
Trash 1
You can see Trash Pack 1 here.

Available commands: fight, look, inventory, go <direction>.

>fightr
That's not a verb I recognise.

>fight
You engage the trash pack. The raid moves in!

Trash fight: the raid cleaves through undead...
You have successfully cleared the trash mobs. You can move on.

Available commands: fight, look, inventory, go <direction>.

* * *

>dps
Too late! The Bone Graveyard tombs weren't destroyed in time.

Open World Graveyard
You are at the graveyard outside the raid because you are DEAD. The cold winds howls. Other spirits are whispering to you. Do not listen to them. Go to the light. You can only return by typing release spirit.

You died. Type release spirit.

>release spirit
ICC Entrance
You are now at the ICC entrance inside the citadel. Next to you is a repair man and infront of you is the next room with enemy units.

You release your spirit and fly back to Icecrown Citadel. Status: ALIVE.

Your equipment is a bit damaged from dying.

You can still die and run back 2 more times before your gear becomes useless.

Available commands: go <direction>, look, inventory, die (debug), repair (if needed).

>repair
You repair your gear. Everything feels solid again.

Available commands: go <direction>, look, inventory, die (debug), repair (if needed).

* * *

>dps
You burst the bone tombs with heavy DPS!
Lord Marrowgar is defeated! Loot drops: Coldwraith Bracers.
Type loot item to pick it up.

Available commands: fight, look, inventory, go <direction>.

>restart
Are you sure you want to restart?

>y
Icecrown Citadel raid start. Status: ALIVE.

MAIN
An Interactive Fiction by Jan Pobi
Release 1 / Serial number 260108 / Inform 7 v10.1.2 / D

ICC Entrance
You are now at the ICC entrance inside the citadel. Next to you is a repair man and infront of you is the next room with enemy units.

>n
Trash 1
You can see Trash Pack 1 here.

Available commands: fight, look, inventory, go <direction>.

* * *

>dps
You burst the bone tombs with heavy DPS!
Lord Marrowgar is defeated!
 Loot drops: Coldwraith Bracers.
Type loot item to pick it up.

Available commands: fight, look, inventory, go <direction>.

>w
Trash 2
You can see Trash Pack 2 here.

Available commands: fight, look, inventory, go <direction>.

* * *

>fight
You pull Gunship Battle! The boss encounter begins!

Gunship Battle begins!To board the enemy ship, you must equip rocket.
Type equip rocket (you have 5 seconds).

Available commands: (in combat) wait, look, inventory, dodge (if asked), dps (if asked).

>equip rocket
You equip the rocket pack. Jump to the enemy ship!
Type jump.

Available commands: (in combat) wait, look, inventory, dodge (if asked), dps (if asked).

>jump
You jump on the spot.

Available commands: (in combat) wait, look, inventory, dodge (if asked), dps (if asked).

>jump
Too late! You fail to jump and the enemy overwhelms you.

Open World Graveyard
You are at the graveyard outside the raid because you are DEAD. The cold winds howls. Other spirits are whispering to you. Do not listen to them. Go to the light. You can only return by typing release spirit.

You died. Type release spirit.

* * *

>look
Boss Room 1
You can see Lord Marrowgar here.

Available commands: (in combat) wait, look, inventory, dodge (if asked), dps (if asked).

>look
Too late! The Bone Graveyard tombs weren't destroyed in time.

Open World Graveyard
The cold winds howl. You are at the graveyard outside the raid. You can only return by typing release spirit.

You died. Type release spirit.

>release
ICC Entrance
You stand at the gates of Icecrown Citadel.

You release your spirit and fly back to Icecrown Citadel. Status: ALIVE.

Your equipment is a bit damaged from dying.

You can still die and run back 2 more times before your gear becomes useless.

Available commands: go <direction>, look, inventory, die (debug), repair (if needed).

>n
Trash 1
You can see Trash Pack 1 here.

The dead Trash Pack 1 lies here. The trash pack is cleared.

Available commands: fight, look, inventory, go <direction>.

* * *

>look
Boss Room 1
You can see Lord Marrowgar here.

Available commands: (in combat) wait, look, inventory, dodge (if asked), dps (if asked).

>look
Too late! Bone Storm already hits you.

Open World Graveyard
The cold winds howl. You are at the graveyard outside the raid. You can only return by typing release spirit.

You died. Type release spirit.

>release
ICC Entrance
You stand at the gates of Icecrown Citadel.

You release your spirit and fly back to Icecrown Citadel. Status: ALIVE.

Your equipment is a bit damaged from dying.

Careful: you can only die and run back 1 more time before your gear becomes useless.

Available commands: go <direction>, look, inventory, die (debug), repair (if needed).

>repair
You repair your gear. Everything feels solid again.

Available commands: go <direction>, look, inventory, die (debug), repair (if needed).

* * *

>look
Boss Room 1
You can see Lord Marrowgar here.

Available commands: (in combat) wait, look, inventory, dodge (if asked), dps (if asked).

>dodge
Too late! Bone Storm already hits you.

Open World Graveyard
The cold winds howl. You are at the graveyard outside the raid. You can only return by typing release spirit.

You died. Type release spirit.

>release
ICC Entrance
You stand at the gates of Icecrown Citadel.

You release your spirit and fly back to Icecrown Citadel. Status: ALIVE.

Your equipment is a bit damaged from dying.

You can still die and run back 2 more times before your gear becomes useless.

Available commands: go <direction>, look, inventory, die (debug), repair (if needed).

* * *

>fight
You pull Lord Marrowgar! The boss encounter begins!

Lord Marrowgar begins Bone Storm!You have 5 seconds to type DODGE or you die.

Available commands: (in combat) wait, look, inventory, dodge (if asked), dps (if asked).

>dps
Now is not the time to DPS.

Available commands: (in combat) wait, look, inventory, dodge (if asked), dps (if asked).

>dodge
Too late! Bone Storm already hits you.

Open World Graveyard
You are at the graveyard outside the raid because you are DEAD. The cold winds howls. Other spirits are whispering to you. Do not listen to them. Go to the light. You can only return by typing release spirit.

You died. Type release spirit.

* * *

>dps
You burst the bone tombs with heavy DPS!
Lord Marrowgar is defeated! Loot drops: Coldwraith Bracers.
Type loot item to pick it up.

Available commands: fight, look, inventory, go <direction>.

>n
You can't go that way.

Available commands: fight, look, inventory, go <direction>.

>west
Trash 2
You can see Trash Pack 2 here.

Available commands: fight, look, inventory, go <direction>.

* * *

>n
Boss Room 2
You can see Lady Deathwhisper here.

Available commands: fight, look, inventory, go <direction>.

>fight
You pull Lady Deathwhisper! The boss encounter begins!

Boss fight: Lady Deathwhisper presses the raid...
Lady Deathwhisper uses a raid-wide ability!
A random raider fails a mechanic and takes huge damage!

Available commands: (in combat) wait, look, inventory, dodge (if asked), dps (if asked).

>south
You can't leave now - the boss fight is in progress!

Boss fight: Lady Deathwhisper presses the raid...
A random raider fails a mechanic and takes huge damage!

Available commands: (in combat) wait, look, inventory, dodge (if asked), dps (if asked).

>n
Lady Deathwhisper blocks the way. Type fight to start the encounter.

Boss fight: Lady Deathwhisper presses the raid...

Boss defeated! Loot drops: Chestguard of the Frigid Noose.
Type loot item to pick it up.

Available commands: fight, look, inventory, go <direction>.

>restart
Are you sure you want to restart?

* * *

>fight
You pull Lord Marrowgar! The boss encounter begins!

Lord Marrowgar begins Bone Storm!You have 5 seconds to type DODGE or you die.

Available commands: (in combat) wait, look, inventory, dodge (if asked), dps (if asked).

>n
Lord Marrowgar blocks the way. Type fight to start the encounter.

Available commands: (in combat) wait, look, inventory, dodge (if asked), dps (if asked).

>look
Too late! Bone Storm already hits you.

Open World Graveyard
You are at the graveyard outside the raid because you are DEAD. The cold winds howls. Other spirits are whispering to you. Do not listen to them. Go to the light. You can only return by typing release spirit.

You died. Type release spirit.

>release
ICC Entrance
You are now at the ICC entrance inside the citadel. Next to you is a repair man and infront of you is the next room with enemy units.

You release your spirit and fly back to Icecrown Citadel. Status: ALIVE.

Your equipment is a bit damaged from dying.

You can still die and run back 2 more times before your gear becomes useless.

Available commands: go <direction>, look, inventory, die (debug), repair (if needed).

* * *

>fight
You pull Lord Marrowgar! The boss encounter begins!

Lord Marrowgar begins Bone Storm!You have 5 seconds to type DODGE or you die.

Available commands: (in combat) wait, look, inventory, dodge (if asked), dps (if asked).

>s
You can't leave now - the boss fight is in progress!

Available commands: (in combat) wait, look, inventory, dodge (if asked), dps (if asked).

>dodge
Too late! Bone Storm already hits you.

Open World Graveyard
You are at the graveyard outside the raid because you are DEAD. The cold winds howls. Other spirits are whispering to you. Do not listen to them. Go to the light. You can only return by typing release spirit.

You died. Type release spirit.

>release
ICC Entrance
You are now at the ICC entrance inside the citadel. Next to you is a repair man and infront of you is the next room with enemy units.

You release your spirit and fly back to Icecrown Citadel. Status: ALIVE.

Your equipment is a bit damaged from dying.

Careful: you can only die and run back 1 more time before your gear becomes useless.

Available commands: go <direction>, look, inventory, die (debug), repair (if needed).

* * *

>n
Boss Room 1
You can see Lord Marrowgar here.

Available commands: fight, look, inventory, go <direction>.

>n
Lord Marrowgar blocks the way. Type fight to start the encounter.

Available commands: fight, look, inventory, go <direction>.

>fight
You pull Lord Marrowgar! The boss encounter begins!

Lord Marrowgar begins Bone Storm!You have 5 seconds to type DODGE or you die.

Available commands: (in combat) wait, look, inventory, dodge (if asked), dps (if asked).

* * *

>dps
You burst the bone tombs with heavy DPS!
Lord Marrowgar is defeated! Loot drops: Shawl of Nerubian Silk.
Type loot item to pick it up.

Available commands: fight, look, inventory, go <direction>.

>w
Trash 2
You can see Trash Pack 2 here.

Available commands: fight, look, inventory, go <direction>.

* * *

>dps boss
Her shield shatters! Lady Deathwhisper moves to the center!
Type finish boss to follow and kill her.

Available commands: (in combat) wait, look, inventory, dodge (if asked), dps (if asked).

>finish boss
Lady Deathwhisper is defeated!Loot drops: Deathspeaker Zealot's Helm.
Type loot item to pick it up.

Available commands: fight, look, inventory, go <direction>.

>look
Boss Room 2
You can see Deathspeaker Zealot's Helm and Lady Deathwhisper here.

Lady Deathwhisper lies defeated on the cold stone.

Available commands: fight, look, inventory, go <direction>.

>fight
This boss is already defeated.

Available commands: fight, look, inventory, go <direction>.

>n
Trash 3
You can see Trash Pack 3 here.

Available commands: fight, look, inventory, go <direction>.

* * *

>n
Boss Room 3
You can see Gunship Battle here.

Available commands: fight, look, inventory, go <direction>.

>restart
Are you sure you want to restart?

* * *

>dodge
You DODGE Bone Storm just in time!
Marrowgar follows up with Bone Graveyard - bone tombs trap players!
You have 5 seconds to type DPS.

Available commands: (in combat) wait, look, inventory, dodge (if asked), dps (if asked).

>fight
You're already in combat!

Available commands: (in combat) wait, look, inventory, dodge (if asked), dps (if asked).

>dps
Too late! The Bone Graveyard tombs weren't destroyed in time.

Open World Graveyard
You are at the graveyard outside the raid because you are DEAD. The cold winds howls. Other spirits are whispering to you. Do not listen to them. Go to the light. You can only return by typing release spirit.

You died. Type release spirit.

>release
ICC Entrance
You are now at the ICC entrance inside the citadel. Next to you is a repair man and infront of you is the next room with enemy units.

You release your spirit and fly back to Icecrown Citadel. Status: ALIVE.

Your equipment is a bit damaged from dying.

You can still die and run back 2 more times before your gear becomes useless.

Available commands: go <direction>, look, inventory, die (debug), repair (if needed).

* * *

>n
Trash 1
You can see Trash Pack 1 here.

The dead Trash Pack 1 lies here. The trash pack is cleared.

Available commands: fight, look, inventory, go <direction>.

>fight
This trash is already cleared.

Available commands: fight, look, inventory, go <direction>.

>n
Boss Room 1
You can see Lord Marrowgar here.

Available commands: fight, look, inventory, go <direction>.

* * *

>dps
No need to DPS here.

Available commands: (in combat) wait, look, inventory, dodge (if asked), dps (if asked).

>dps
Too late! Her shield never drops and the raid wipes.

Open World Graveyard
You are at the graveyard outside the raid because you are DEAD. The cold winds howls. Other spirits are whispering to you. Do not listen to them. Go to the light. You can only return by typing release spirit.

You died. Type release spirit.

>release
ICC Entrance
You are now at the ICC entrance inside the citadel. Next to you is a repair man and infront of you is the next room with enemy units.

You release your spirit and fly back to Icecrown Citadel. Status: ALIVE.

Your equipment is a bit damaged from dying.

Careful: you can only die and run back 1 more time before your gear becomes useless.

Available commands: go <direction>, look, inventory, die (debug), repair (if needed).

* * *

>look
Trash 1
You can see Trash Pack 1 here.

Available commands: fight, look, inventory, go <direction>.

>fight
You engage the trash pack. The raid moves in!

Trash fight: the raid cleaves through undead...
You have successfully cleared the trash mobs. You can move on.

Available commands: fight, look, inventory, go <direction>.

>look
Trash 1
You can see Trash Pack 1 here.

The dead Trash Pack 1 lies here. The trash pack is cleared.

Available commands: fight, look, inventory, go <direction>.

>n
Boss Room 1
You can see Lord Marrowgar here.

Available commands: fight, look, inventory, go <direction>.

* * *

>fight
You pull Lord Marrowgar! The boss encounter begins!

Lord Marrowgar begins Bone Storm!You have 5 seconds to type DODGE or you die.

Available commands: (in combat) wait, look, inventory, dodge (if asked), dps (if asked).

>dod
That's not a verb I recognise.

>dodge
You DODGE Bone Storm just in time!
Marrowgar follows up with Bone Graveyard - bone tombs trap players!
You have 5 seconds to type DPS.

Available commands: (in combat) wait, look, inventory, dodge (if asked), dps (if asked).

* * *

>dps
You burst the bone tombs with heavy DPS!
Lord Marrowgar is defeated! Loot drops: Shawl of Nerubian Silk.
Type loot item to pick it up.

Available commands: fight, look, inventory, go <direction>.

>n
You can't go that way.

Available commands: fight, look, inventory, go <direction>.

>look
Boss Room 1
You can see Shawl of Nerubian Silk and Lord Marrowgar here.

Lord Marrowgar lies defeated on the cold stone.

Available commands: fight, look, inventory, go <direction>.

>west
Trash 2
You can see Trash Pack 2 here.

Available commands: fight, look, inventory, go <direction>.

* * *

>n
Boss Room 2
You can see Lady Deathwhisper here.

Available commands: fight, look, inventory, go <direction>.

>fight
You pull Lady Deathwhisper! The boss encounter begins!

Boss fight: Lady Deathwhisper presses the raid...

Available commands: (in combat) wait, look, inventory, dodge (if asked), dps (if asked).

>dps
No need to DPS here.

Boss fight: Lady Deathwhisper presses the raid...
Lady Deathwhisper uses a raid-wide ability!

Available commands: (in combat) wait, look, inventory, dodge (if asked), dps (if asked).

>dps
No need to DPS here.

Boss fight: Lady Deathwhisper presses the raid...
Lady Deathwhisper uses a raid-wide ability!
A random raider fails a mechanic and takes huge damage!

Boss defeated! Loot drops: Ghoul Commander's Cuirass.
Type loot item to pick it up.

Available commands: fight, look, inventory, go <direction>.

>n
Trash 3
You can see Trash Pack 3 here.

Available commands: fight, look, inventory, go <direction>.

* * *

>n
Boss Room 3
You can see Gunship Battle here.

Available commands: fight, look, inventory, go <direction>.

>fight
You pull Gunship Battle! The boss encounter begins!

Boss fight: Gunship Battle presses the raid...
Gunship Battle uses a raid-wide ability!
A random raider fails a mechanic and takes huge damage!

Available commands: (in combat) wait, look, inventory, dodge (if asked), dps (if asked).

>dos
That's not a verb I recognise.

>dps
No need to DPS here.

Boss fight: Gunship Battle presses the raid...

Available commands: (in combat) wait, look, inventory, dodge (if asked), dps (if asked).

>dps
No need to DPS here.

Boss fight: Gunship Battle presses the raid...
Gunship Battle uses a raid-wide ability!

Boss defeated! Loot drops: Pauldrons of Lost Hope.
Type loot item to pick it up.

Available commands: fight, look, inventory, go <direction>.

>n
Trash 4
You can see Trash Pack 4 here.

Available commands: fight, look, inventory, go <direction>.

* * *

>n
Boss Room 4
You can see Deathbringer Saurfang here.

Available commands: fight, look, inventory, go <direction>.

>fight
You pull Deathbringer Saurfang! The boss encounter begins!

Boss fight: Deathbringer Saurfang presses the raid...

Available commands: (in combat) wait, look, inventory, dodge (if asked), dps (if asked).

>dps
No need to DPS here.

Boss fight: Deathbringer Saurfang presses the raid...
Deathbringer Saurfang uses a raid-wide ability!
A random raider fails a mechanic and takes huge damage!

Available commands: (in combat) wait, look, inventory, dodge (if asked), dps (if asked).

>dodge
No need to dodge here.

Boss fight: Deathbringer Saurfang presses the raid...

Boss defeated! Loot drops: Thaumaturge's Crackling Cowl.
Type loot item to pick it up.

Available commands: fight, look, inventory, go <direction>.

>n
You can't go that way.

Available commands: fight, look, inventory, go <direction>.

* * *

>west
You can't go that way.

Available commands: fight, look, inventory, go <direction>.

>east
Trash 5
You can see Trash Pack 5 here.

Available commands: fight, look, inventory, go <direction>.

>n
Trash blocks the way. Type fight to clear it.

Available commands: fight, look, inventory, go <direction>.

>fight
You engage the trash pack. The raid moves in!

Trash fight: the raid cleaves through undead...
You have successfully cleared the trash mobs. You can move on.

Available commands: fight, look, inventory, go <direction>.

>look
Trash 5
You can see Trash Pack 5 here.

The dead Trash Pack 5 lies here. The trash pack is cleared.

Available commands: fight, look, inventory, go <direction>.

>n
You can't go that way.

Available commands: fight, look, inventory, go <direction>.

>w
Boss Room 4
You can see Thaumaturge's Crackling Cowl and Deathbringer Saurfang here.

Deathbringer Saurfang lies defeated on the cold stone.

Available commands: fight, look, inventory, go <direction>.

>east
Trash 5
You can see Trash Pack 5 here.

The dead Trash Pack 5 lies here. The trash pack is cleared.

Available commands: fight, look, inventory, go <direction>.

* * *

>east
Boss Room 5
You can see Festergut here.

Available commands: fight, look, inventory, go <direction>.

>fight
You pull Festergut! The boss encounter begins!

Boss fight: Festergut presses the raid...
A random raider fails a mechanic and takes huge damage!

Available commands: (in combat) wait, look, inventory, dodge (if asked), dps (if asked).

>dps
No need to DPS here.

Boss fight: Festergut presses the raid...
A random raider fails a mechanic and takes huge damage!

Available commands: (in combat) wait, look, inventory, dodge (if asked), dps (if asked).

I beg your pardon?

>d
You can't go that way.

Boss fight: Festergut presses the raid...
Festergut uses a raid-wide ability!

Boss defeated! Loot drops: Cloak of Many Skins.
Type loot item to pick it up.

Available commands: fight, look, inventory, go <direction>.

>dps
There's nothing to DPS right now.

Available commands: fight, look, inventory, go <direction>.

>dodge
You can only dodge during combat.

Available commands: fight, look, inventory, go <direction>.

>look
Boss Room 5
You can see Cloak of Many Skins and Festergut here.

Festergut lies defeated on the cold stone.

Available commands: fight, look, inventory, go <direction>.

>loot item
Taken.

Available commands: fight, look, inventory, go <direction>.

>look
Boss Room 5
You can see Festergut here.

Festergut lies defeated on the cold stone.

Available commands: fight, look, inventory, go <direction>.

>n
You can't go that way.

Available commands: fight, look, inventory, go <direction>.

>east
You can't go that way.

Available commands: fight, look, inventory, go <direction>.

>w
Trash 6
You can see Trash Pack 6 here.

Available commands: fight, look, inventory, go <direction>.

>fight
You engage the trash pack. The raid moves in!

Trash fight: the raid cleaves through undead...
You have successfully cleared the trash mobs. You can move on.

Available commands: fight, look, inventory, go <direction>.

>n
Boss Room 6
You can see Rotface here.

Available commands: fight, look, inventory, go <direction>.

>fight
You pull Rotface! The boss encounter begins!

Boss fight: Rotface presses the raid...

Available commands: (in combat) wait, look, inventory, dodge (if asked), dps (if asked).

>dps
No need to DPS here.

Boss fight: Rotface presses the raid...
Rotface uses a raid-wide ability!

Available commands: (in combat) wait, look, inventory, dodge (if asked), dps (if asked).

>dps
No need to DPS here.

Boss fight: Rotface presses the raid...
A random raider fails a mechanic and takes huge damage!

Boss defeated! Loot drops: Taldron's Short-Sighted Helm.
Type loot item to pick it up.

Available commands: fight, look, inventory, go <direction>.

>loot item
Taken.

Available commands: fight, look, inventory, go <direction>.

>inventory
You are carrying:
  Taldron's Short-Sighted Helm
  Cloak of Many Skins

Available commands: fight, look, inventory, go <direction>.

>n
You can't go that way.

Available commands: fight, look, inventory, go <direction>.

>s
Trash 7
You can see Trash Pack 7 here.

Available commands: fight, look, inventory, go <direction>.

>fight
You engage the trash pack. The raid moves in!

Trash fight: the raid cleaves through undead...
You have successfully cleared the trash mobs. You can move on.

Available commands: fight, look, inventory, go <direction>.

>n
Boss Room 7
You can see Professor Putricide here.

Available commands: fight, look, inventory, go <direction>.

>fight
You pull Professor Putricide! The boss encounter begins!

Boss fight: Professor Putricide presses the raid...
Professor Putricide uses a raid-wide ability!
A random raider fails a mechanic and takes huge damage!

Available commands: (in combat) wait, look, inventory, dodge (if asked), dps (if asked).

I beg your pardon?

I beg your pardon?

>d
You can't go that way.

Boss fight: Professor Putricide presses the raid...

Available commands: (in combat) wait, look, inventory, dodge (if asked), dps (if asked).

>s
Trash 7
You can see Trash Pack 7 here.

The dead Trash Pack 7 lies here. The trash pack is cleared.

Trash fight: the raid cleaves through undead...
You have successfully cleared the trash mobs. You can move on.

Available commands: fight, look, inventory, go <direction>.

>d
You can't go that way.

Available commands: fight, look, inventory, go <direction>.

>dps
There's nothing to DPS right now.

Available commands: fight, look, inventory, go <direction>.

>look
Trash 7
You can see Trash Pack 7 here.

The dead Trash Pack 7 lies here. The trash pack is cleared.

Available commands: fight, look, inventory, go <direction>.

>n
Boss Room 7
You can see Professor Putricide here.

Available commands: fight, look, inventory, go <direction>.

* * *

>fight
You pull Professor Putricide! The boss encounter begins!

Boss fight: Professor Putricide presses the raid...

Available commands: (in combat) wait, look, inventory, dodge (if asked), dps (if asked).

>south
Trash 7
You can see Trash Pack 7 here.

The dead Trash Pack 7 lies here. The trash pack is cleared.

Trash fight: the raid cleaves through undead...
You have successfully cleared the trash mobs. You can move on.

Available commands: fight, look, inventory, go <direction>.

I beg your pardon?

>look
Trash 7
You can see Trash Pack 7 here.

The dead Trash Pack 7 lies here. The trash pack is cleared.

Available commands: fight, look, inventory, go <direction>.

* * *

>fight
You pull Professor Putricide! The boss encounter begins!

Boss fight: Professor Putricide presses the raid...
Professor Putricide uses a raid-wide ability!
A random raider fails a mechanic and takes huge damage!

Available commands: (in combat) wait, look, inventory, dodge (if asked), dps (if asked).

>dps
No need to DPS here.

Boss fight: Professor Putricide presses the raid...
Professor Putricide uses a raid-wide ability!

Available commands: (in combat) wait, look, inventory, dodge (if asked), dps (if asked).

>dps
No need to DPS here.

Boss fight: Professor Putricide presses the raid...

Boss defeated! Loot drops: The Facelifter.
Type loot item to pick it up.

Available commands: fight, look, inventory, go <direction>.

>loot item
Taken.

Available commands: fight, look, inventory, go <direction>.

>inventory
You are carrying:
  The Facelifter
  Taldron's Short-Sighted Helm
  Cloak of Many Skins

Available commands: fight, look, inventory, go <direction>.

>n
Trash 8
You can see Trash Pack 8 here.

Available commands: fight, look, inventory, go <direction>.

>fight
You engage the trash pack. The raid moves in!

Trash fight: the raid cleaves through undead...
You have successfully cleared the trash mobs. You can move on.

Available commands: fight, look, inventory, go <direction>.

>n
Boss Room 8
You can see Blood Prince Council here.

Available commands: fight, look, inventory, go <direction>.

* * *

>fight
You pull Blood Prince Council! The boss encounter begins!

Boss fight: Blood Prince Council presses the raid...
Blood Prince Council uses a raid-wide ability!

Available commands: (in combat) wait, look, inventory, dodge (if asked), dps (if asked).

>dps
No need to DPS here.

Boss fight: Blood Prince Council presses the raid...
Blood Prince Council uses a raid-wide ability!
A random raider fails a mechanic and takes huge damage!

Available commands: (in combat) wait, look, inventory, dodge (if asked), dps (if asked).

>dps
No need to DPS here.

Boss fight: Blood Prince Council presses the raid...

Boss defeated! Loot drops: Spaulders of the Blood Princes.
Type loot item to pick it up.

Available commands: fight, look, inventory, go <direction>.

>n
You can't go that way.

Available commands: fight, look, inventory, go <direction>.

* * *

>west
You can't go that way.

Available commands: fight, look, inventory, go <direction>.

>e
Trash 9
You can see Trash Pack 9 here.

Available commands: fight, look, inventory, go <direction>.

>n
Trash blocks the way. Type fight to clear it.

Available commands: fight, look, inventory, go <direction>.

* * *

>fight
You engage the trash pack. The raid moves in!

Trash fight: the raid cleaves through undead...
You have successfully cleared the trash mobs. You can move on.

Available commands: fight, look, inventory, go <direction>.

>n
Boss Room 9
You can see Blood-Queen Lana'thel here.

Available commands: fight, look, inventory, go <direction>.

>fight
You pull Blood-Queen Lana'thel! The boss encounter begins!

Boss fight: Blood-Queen Lana'thel presses the raid...

Available commands: (in combat) wait, look, inventory, dodge (if asked), dps (if asked).

>dps
No need to DPS here.

Boss fight: Blood-Queen Lana'thel presses the raid...
Blood-Queen Lana'thel uses a raid-wide ability!

Available commands: (in combat) wait, look, inventory, dodge (if asked), dps (if asked).

>dp
That's not a verb I recognise.

>dps
No need to DPS here.

Boss fight: Blood-Queen Lana'thel presses the raid...

Boss defeated! Loot drops: Bloodfall.
Type loot item to pick it up.

Available commands: fight, look, inventory, go <direction>.

>loot item
Taken.

Available commands: fight, look, inventory, go <direction>.

>n
Trash 10
You can see Trash Pack 10 here.

Available commands: fight, look, inventory, go <direction>.

>fight
You engage the trash pack. The raid moves in!

Trash fight: the raid cleaves through undead...
You have successfully cleared the trash mobs. You can move on.

Available commands: fight, look, inventory, go <direction>.

>n
Boss Room 10
You can see Valithria Dreamwalker here.

Available commands: fight, look, inventory, go <direction>.

>fight
You pull Valithria Dreamwalker! The boss encounter begins!

Boss fight: Valithria Dreamwalker presses the raid...
Valithria Dreamwalker uses a raid-wide ability!
A random raider fails a mechanic and takes huge damage!

Available commands: (in combat) wait, look, inventory, dodge (if asked), dps (if asked).

>dps
No need to DPS here.

Boss fight: Valithria Dreamwalker presses the raid...
Valithria Dreamwalker uses a raid-wide ability!

Available commands: (in combat) wait, look, inventory, dodge (if asked), dps (if asked).

>dps
No need to DPS here.

Boss fight: Valithria Dreamwalker presses the raid...
Valithria Dreamwalker uses a raid-wide ability!
A random raider fails a mechanic and takes huge damage!

Boss defeated! Loot drops: Sister Svalna's Spangenhelm.
Type loot item to pick it up.

Available commands: fight, look, inventory, go <direction>.

>n
You can't go that way.

Available commands: fight, look, inventory, go <direction>.

>e
You can't go that way.

Available commands: fight, look, inventory, go <direction>.

>w
You can't go that way.

Available commands: fight, look, inventory, go <direction>.

>s
Trash 11
You can see Trash Pack 11 here.

Available commands: fight, look, inventory, go <direction>.

>n
Trash blocks the way. Type fight to clear it.

Available commands: fight, look, inventory, go <direction>.

* * *

>fight
You engage the trash pack. The raid moves in!

Trash fight: the raid cleaves through undead...
You have successfully cleared the trash mobs. You can move on.

Available commands: fight, look, inventory, go <direction>.

>n
Boss Room 11
You can see Sindragosa here.

Available commands: fight, look, inventory, go <direction>.

* * *

>dps
No need to DPS here.

Boss fight: Sindragosa presses the raid...

Available commands: (in combat) wait, look, inventory, dodge (if asked), dps (if asked).

>dps
No need to DPS here.

Boss fight: Sindragosa presses the raid...
Sindragosa uses a raid-wide ability!

Boss defeated! Loot drops: Rimetooth Pendant.
Type loot item to pick it up.

Available commands: fight, look, inventory, go <direction>.

>loot item
Taken.

Available commands: fight, look, inventory, go <direction>.

>n
You can't go that way.

Available commands: fight, look, inventory, go <direction>.

* * *

>e
You can't go that way.

Available commands: fight, look, inventory, go <direction>.

>s
Trash 12
You can see Trash Pack 12 here.

Available commands: fight, look, inventory, go <direction>.

>dps
There's nothing to DPS right now.

Available commands: fight, look, inventory, go <direction>.

>fight
You engage the trash pack. The raid moves in!

Trash fight: the raid cleaves through undead...
You have successfully cleared the trash mobs. You can move on.

Available commands: fight, look, inventory, go <direction>.

>dps
There's nothing to DPS right now.

Available commands: fight, look, inventory, go <direction>.

>n
Boss Room 12
You can see a Lich King here.

Available commands: fight, look, inventory, go <direction>.

>fight
You pull the Lich King! The boss encounter begins!

Boss fight: The Lich King presses the raid...
The Lich King uses a raid-wide ability!

Available commands: (in combat) wait, look, inventory, dodge (if asked), dps (if asked).

>dps
No need to DPS here.

Boss fight: The Lich King presses the raid...

Available commands: (in combat) wait, look, inventory, dodge (if asked), dps (if asked).

>dps
No need to DPS here.

Boss fight: The Lich King presses the raid...

Boss defeated! Loot drops: Glorenzelg, High-Blade of the Silver Hand.
Type loot item to pick it up.

Available commands: fight, look, inventory, go <direction>.

>loot item
Taken.

Available commands: fight, look, inventory, go <direction>.

>inventory
You are carrying:
  Glorenzelg, High-Blade of the Silver Hand
  Rimetooth Pendant
  Bloodfall
  The Facelifter
  Taldron's Short-Sighted Helm
  Cloak of Many Skins

Available commands: fight, look, inventory, go <direction>.

* * *

>n
Trash 1
You can see Trash Pack 1 here.

Available commands: fight, look, inventory, go <direction>.

>n
Trash blocks the way. Type fight to clear it.

Available commands: fight, look, inventory, go <direction>.

>f
That's not a verb I recognise.

>fi
That's not a verb I recognise.

>fig
That's not a verb I recognise.

>figh
That's not a verb I recognise.

>fight
You engage the trash pack. The raid moves in!

Trash fight: the raid cleaves through undead...
You have successfully cleared the trash mobs. You can move on.

Available commands: fight, look, inventory, go <direction>.

* * *

>look
Boss Room 1
You can see Lord Marrowgar here.

Available commands: fight, look, inventory, go <direction>.

>info
That's not a verb I recognise.

* * *

Welcome to Icecrown Citadel, mortal. Status: ALIVE.

MAIN
An Interactive Fiction by Jan Pobi
Release 1 / Serial number 260112 / Inform 7 v10.1.2 / D

ICC Entrance
You are now at the ICC entrance inside the citadel. Next to you is a repair man and infront of you is the next room with enemy units.

You can see an Entrance Teleporter here.

>north
Trash 1
You can see Trash Pack 1 here.

Available commands: fight, look, inventory, go <direction>.

* * *

>fight
You engage the trash pack. The raid moves in!

Trash fight: the raid cleaves through undead...
Trash cleared. You can move on.

Available commands: fight, look, inventory, go <direction>.

>north
Boss Room 1
You can see Lord Marrowgar here.

Available commands: fight, look, inventory, go <direction>.

* * *

>dodge
You DODGE Bone Storm just in time!
Marrowgar follows up with Bone Graveyard - bone tombs trap players!
You have 10 seconds to type DPS.

Available commands: (in combat) wait, look, inventory, dodge (if asked), dps (if asked).

>look
Boss Room 1
You can see Lord Marrowgar here.

You fail to break the Bone Graveyard tombs in time. The raid collapses.

Open World Graveyard
The cold winds howl. You are at the graveyard outside the raid. You can only return by typing release spirit.

You died. Type release spirit.

>release
ICC Entrance
You stand at the gates of Icecrown Citadel.

You release your spirit and fly back to Icecrown Citadel. Status: ALIVE.

Your equipment is a bit damaged from dying.

You can still die and run back 2 more times before your gear becomes useless.

Available commands: go <direction>, look, inventory, die (debug), repair (if needed).

>north
Trash 1
You can see Trash Pack 1 here.

Available commands: fight, look, inventory, go <direction>.

* * *

>fight
You pull Lord Marrowgar! The boss encounter begins!

Lord Marrowgar begins Bone Storm!You have 10 seconds to type DODGE or you die.

Available commands: (in combat) wait, look, inventory, dodge (if asked), dps (if asked).

>look
Boss Room 1
You can see Lord Marrowgar here.

You fail to dodge Bone Storm. It's a massacre.

Open World Graveyard
The cold winds howl. You are at the graveyard outside the raid. You can only return by typing release spirit.

You died. Type release spirit.

>release
ICC Entrance
You stand at the gates of Icecrown Citadel.

You release your spirit and fly back to Icecrown Citadel. Status: ALIVE.

Your equipment is a bit damaged from dying.

Careful: you can only die and run back 1 more time before your gear becomes useless.

Available commands: go <direction>, look, inventory, die (debug), repair (if needed).

* * *

>north
Trash blocks the way. Type fight to clear it.

Available commands: fight, look, inventory, go <direction>.

>fight
You engage the trash pack. The raid moves in!

Trash fight: the raid cleaves through undead...
Trash cleared. You can move on.

Available commands: fight, look, inventory, go <direction>.

* * *

>north
Boss Room 1
You can see Lord Marrowgar here.

Available commands: fight, look, inventory, go <direction>.

>south
Trash 1
You can see Trash Pack 1 here.

Available commands: fight, look, inventory, go <direction>.

>north
Boss Room 1
You can see Lord Marrowgar here.

Available commands: fight, look, inventory, go <direction>.

* * *

>dps
You burst the bone tombs with heavy DPS!
Lord Marrowgar is defeated! Loot drops: Marrowgar's Scratching Choker.

Available commands: fight, look, inventory, go <direction>.

>die
Open World Graveyard
The cold winds howl. You are at the graveyard outside the raid. You can only return by typing release spirit.

You died. Type release spirit.

>release
ICC Entrance
You stand at the gates of Icecrown Citadel.

You release your spirit and fly back to Icecrown Citadel. Status: ALIVE.

Your equipment is a bit damaged from dying.

You can still die and run back 2 more times before your gear becomes useless.

Available commands: go <direction>, look, inventory, die (debug), repair (if needed).

* * *

>repair
You repair your gear. Everything feels solid again.

Available commands: go <direction>, look, inventory, die (debug), repair (if needed).

>look
ICC Entrance
You stand at the gates of Icecrown Citadel.

Available commands: go <direction>, look, inventory, die (debug), repair (if needed).

* * *

>north
Boss Room 1
You can see Lord Marrowgar here.

Available commands: fight, look, inventory, go <direction>.

>north
You can't go that way.

Available commands: fight, look, inventory, go <direction>.

* * *

Welcome to Icecrown Citadel, mortal. Status: ALIVE.

MAIN
An Interactive Fiction by Jan Pobi
Release 1 / Serial number 260112 / Inform 7 v10.1.2 / D

ICC Entrance
You are now at the ICC entrance inside the citadel. Next to you is a repair man and infront of you is the next room with enemy units.

You can see an Entrance Teleporter here.

>teleport
Teleport destinations:
 - 1: Boss Room 1
 - 2: Boss Room 2
 - 3: Boss Room 3
 - 4: Boss Room 4
 - 5: Boss Room 5
 - 6: Boss Room 6
 - 7: Boss Room 7
 - 8: Boss Room 8
 - 9: Boss Room 9
 - 10: Boss Room 10
 - 11: Boss Room 11
 - 12: Boss Room 12

Use: teleport to <number>.

Available commands: go <direction>, look, inventory, die (debug), repair (if needed).

>teleport to 12
Boss Room 12
You can see a Lich King here.

You step into the teleporter... Destination reached.
Boss Room 12
You can see a Lich King here.

Available commands: fight, look, inventory, go <direction>.

>teleport
There is no teleporter here.

Available commands: fight, look, inventory, go <direction>.

>teleport to 1
There is no teleporter here.

Available commands: fight, look, inventory, go <direction>.

>look
Boss Room 12
You can see a Lich King here.

Available commands: fight, look, inventory, go <direction>.

>fight
You pull the Lich King! The boss encounter begins!

Available commands: (in combat) wait, look, inventory, dodge (if asked), dps (if asked).

>dps
No need to DPS here.

Available commands: (in combat) wait, look, inventory, dodge (if asked), dps (if asked).

>die
Open World Graveyard
You are at the graveyard outside the raid because you are DEAD. The cold winds howls. Other spirits are whispering to you. Do not listen to them. Go to the light. You can only return by typing release spirit.

You died. Type release spirit.

>release
ICC Entrance
You are now at the ICC entrance inside the citadel. Next to you is a repair man and infront of you is the next room with enemy units.

You can see an Entrance Teleporter here.

You release your spirit and fly back to Icecrown Citadel. Status: ALIVE.

Your equipment is a bit damaged from dying.

You can still die and run back 2 more times before your gear becomes useless.

Available commands: (in combat) wait, look, inventory, dodge (if asked), dps (if asked).

>repair
You repair your gear. Everything feels solid again.

Available commands: (in combat) wait, look, inventory, dodge (if asked), dps (if asked).

>look
ICC Entrance
You are now at the ICC entrance inside the citadel. Next to you is a repair man and infront of you is the next room with enemy units.

You can see an Entrance Teleporter here.

Available commands: (in combat) wait, look, inventory, dodge (if asked), dps (if asked).

>teleport
You can't use the teleporter during combat!

Available commands: (in combat) wait, look, inventory, dodge (if asked), dps (if asked).

>restart
Are you sure you want to restart?

>y
Icecrown Citadel raid start. Status: ALIVE.

MAIN
An Interactive Fiction by Jan Pobi
Release 1 / Serial number 260108 / Inform 7 v10.1.2 / D

ICC Entrance
You are now at the ICC entrance inside the citadel. Next to you is a repair man and infront of you is the next room with enemy units.

You can see an Entrance Teleporter here.

>teleport 4
I only understood you as far as wanting to teleport.

>teleport to 4
Boss Room 4
You can see Deathbringer Saurfang here.

You step into the teleporter... Destination reached.
Boss Room 4
You can see Deathbringer Saurfang here.

Available commands: fight, look, inventory, go <direction>.

>teleport 3
I only understood you as far as wanting to teleport.

>teleport to 3
There is no teleporter here.

Available commands: fight, look, inventory, go <direction>.

>s
Trash 4
You can see Trash Pack 4 here.

Available commands: fight, look, inventory, go <direction>.

>s
Boss Room 3
You can see Gunship Battle here.

Available commands: fight, look, inventory, go <direction>.

>s
Trash 3
You can see Trash Pack 3 here.

Available commands: fight, look, inventory, go <direction>.

>s
Boss Room 2
You can see Lady Deathwhisper here.

Available commands: fight, look, inventory, go <direction>.

>s
Trash 2
You can see Trash Pack 2 here.

Available commands: fight, look, inventory, go <direction>.

>s
You can't go that way.

Available commands: fight, look, inventory, go <direction>.

>s
You can't go that way.

Available commands: fight, look, inventory, go <direction>.

>a
That's not a verb I recognise.

>e
Boss Room 1
You can see Lord Marrowgar here.

Available commands: fight, look, inventory, go <direction>.

>e
You can't go that way.

Available commands: fight, look, inventory, go <direction>.

>s
Trash 1
You can see Trash Pack 1 here.

Available commands: fight, look, inventory, go <direction>.

>s
ICC Entrance
You are now at the ICC entrance inside the citadel. Next to you is a repair man and infront of you is the next room with enemy units.

You can see an Entrance Teleporter here.

Available commands: go <direction>, look, inventory, die (debug), repair (if needed).

>restart
Are you sure you want to restart?

* * *

>y
Icecrown Citadel raid start. Status: ALIVE.

MAIN
An Interactive Fiction by Jan Pobi
Release 1 / Serial number 260108 / Inform 7 v10.1.2 / D

ICC Entrance
You are now at the ICC entrance inside the citadel. Next to you is a repair man and infront of you is the next room with enemy units.

You can see an Entrance Teleporter here.

>look
ICC Entrance
You are now at the ICC entrance inside the citadel. Next to you is a repair man and infront of you is the next room with enemy units.

You can see an Entrance Teleporter here.

Available commands: go <direction>, look, inventory, die (debug), repair (if needed).

>teleporter
That's not a verb I recognise.

* * *

Welcome to Icecrown Citadel, mortal. Status: ALIVE.

MAIN
An Interactive Fiction by Jan Pobi
Release 1 / Serial number 260112 / Inform 7 v10.1.2 / D

ICC Entrance
You are now at the ICC entrance inside the citadel. Next to you is a repair man and infront of you is the next room with enemy units.

You can see an Entrance Teleporter here.

>teleport 10
I only understood you as far as wanting to teleport.

>teleport to 10
Boss Room 10
You can see Valithria Dreamwalker here.

You step into the teleporter... Destination reached.
Boss Room 10
You can see Valithria Dreamwalker here.

Available commands: fight, look, inventory, go <direction>.

>fight
You pull Valithria Dreamwalker! The boss encounter begins!

Valithria Dreamwalker encounter begins!Adds flood the room - you must position correctly!
Go right - type right (you have 5 seconds).

Available commands: (in combat) wait, look, inventory, dodge (if asked), dps (if asked).

>right
You position to the right side of the room!
A Suppressor spawns and starts draining Valithria!
Kill it - type dps suppresor.

Available commands: (in combat) wait, look, inventory, dodge (if asked), dps (if asked).

>dps suppresor
Suppressor down! Valithria breathes easier.
A Blistering Zombie shambles toward you!
Run - type run away.

Available commands: (in combat) wait, look, inventory, dodge (if asked), dps (if asked).

>run away
You kite the zombie away and avoid the explosion!
A Blazing Skeleton spawns - it must die fast!
Type dps skeleton.

Available commands: (in combat) wait, look, inventory, dodge (if asked), dps (if asked).

>dps skeleton
Blazing Skeleton destroyed!
Now support the healers - Valithria must be saved!
Type help healers.

Available commands: (in combat) wait, look, inventory, dodge (if asked), dps (if asked).

>help healers
Valithria Dreamwalker is saved!Loot drops: Sister Svalna's Spangenhelm.
Type loot item to pick it up.

Available commands: fight, look, inventory, go <direction>.

>loot
Taken.

Available commands: fight, look, inventory, go <direction>.

>inventory
You are carrying:
  Sister Svalna's Spangenhelm

Available commands: fight, look, inventory, go <direction>.

* * *

Welcome to Icecrown Citadel, mortal. Status: ALIVE.

MAIN
An Interactive Fiction by Jan Pobi
Release 1 / Serial number 260112 / Inform 7 v10.1.2 / D

ICC Entrance
You are now at the ICC entrance inside the citadel. Next to you is a repair man and infront of you is the next room with enemy units.

You can see an Entrance Teleporter here.

>teleport 5
I only understood you as far as wanting to teleport.

>teleport to 5
Boss Room 5
You can see Festergut here.

You step into the teleporter... Destination reached.
Boss Room 5
You can see Festergut here.

Available commands: fight, look, inventory, go <direction>.

>fight
You pull Festergut! The boss encounter begins!

Festergut begins!An ooze spawns on you! Move it away from the raid!
Type move from raid (you have 5 seconds).

Available commands: (in combat) wait, look, inventory, dodge (if asked), dps (if asked).

>move from raid
You pull the ooze away from the raid just in time!
Now weaken Festergut - type dps boss.

Available commands: (in combat) wait, look, inventory, dodge (if asked), dps (if asked).

>dps boss
You slam Festergut hard and weaken him!
He begins casting Ooze Explosion!
Survive it - type move from boss.

Available commands: (in combat) wait, look, inventory, dodge (if asked), dps (if asked).

>move from boss
You move away at the last second - Ooze Explosion misses you!
Finish him now - type dps boss.

Available commands: (in combat) wait, look, inventory, dodge (if asked), dps (if asked).

>dps boss
Festergut is defeated!Loot drops: Wrists of Septic Shock.
Type loot item to pick it up.

Available commands: fight, look, inventory, go <direction>.

* * *

Welcome to Icecrown Citadel, mortal. Status: ALIVE.

MAIN
An Interactive Fiction by Jan Pobi
Release 1 / Serial number 260112 / Inform 7 v10.1.2 / D

ICC Entrance
You are now at the ICC entrance inside the citadel. Next to you is a repair man and infront of you is the next room with enemy units.

You can see an Entrance Teleporter here.

>teleport 6
I only understood you as far as wanting to teleport.

>teleport to 6
Boss Room 6
You can see Rotface here.

You step into the teleporter... Destination reached.
Boss Room 6
You can see Rotface here.

Available commands: fight, look, inventory, go <direction>.

>fight
You pull Rotface! The boss encounter begins!

Rotface begins!Spore appears on you! You must stack with the raid!
Type stack (you have 5 seconds).

Available commands: (in combat) wait, look, inventory, dodge (if asked), dps (if asked).

>stack
You stack the spores with the raid and stabilize!
Now weaken Rotface - type dps boss.

Available commands: (in combat) wait, look, inventory, dodge (if asked), dps (if asked).

>dps boss
Rotface is LOW! He releases Vile Gas!
Survive it - type defensive.

Available commands: (in combat) wait, look, inventory, dodge (if asked), dps (if asked).

>defensive
You pop defensives and survive Vile Gas!
Finish him - type finish the boss.

Available commands: (in combat) wait, look, inventory, dodge (if asked), dps (if asked).

>finish the boss
Rotface is defeated!Loot drops: Chestguard of the Failed Experiment.
Type loot item to pick it up.

Available commands: fight, look, inventory, go <direction>.

>teleport
There is no teleporter here.

Available commands: fight, look, inventory, go <direction>.

>teleportere
There is no teleporter here.

Available commands: fight, look, inventory, go <direction>.

>teleporter
There is no teleporter here.

Available commands: fight, look, inventory, go <direction>.

>s
Trash 7
You can see Trash Pack 7 here.

Available commands: fight, look, inventory, go <direction>.

>s
You can't go that way.

Available commands: fight, look, inventory, go <direction>.

>e
You can't go that way.

Available commands: fight, look, inventory, go <direction>.

* * *

>w
You can't go that way.

Available commands: fight, look, inventory, go <direction>.

>look
Trash 7
You can see Trash Pack 7 here.

Available commands: fight, look, inventory, go <direction>.

>fight
You engage the trash pack. The raid moves in!

Trash fight: the raid cleaves through undead...
You have successfully cleared the trash mobs. You can move on.

Available commands: fight, look, inventory, go <direction>.

>s
You can't go that way.

Available commands: fight, look, inventory, go <direction>.

>w
You can't go that way.

Available commands: fight, look, inventory, go <direction>.

* * *

>e
You can't go that way.

Available commands: fight, look, inventory, go <direction>.

>n
Boss Room 7
You can see Professor Putricide here.

Available commands: fight, look, inventory, go <direction>.

>restart
Are you sure you want to restart?

* * *

Welcome to Icecrown Citadel, mortal. Status: ALIVE.

MAIN
An Interactive Fiction by Jan Pobi
Release 1 / Serial number 260112 / Inform 7 v10.1.2 / D

ICC Entrance
You are now at the ICC entrance inside the citadel. Next to you is a repair man and infront of you is the next room with enemy units.

You can see an Entrance Teleporter here.

>teleport to 11
Boss Room 11
You can see Sindragosa here.

You step into the teleporter... Destination reached.
Boss Room 11
You can see Sindragosa here.

Available commands: fight, look, inventory, go <direction>.

>fight
You pull Sindragosa! The boss encounter begins!

Sindragosa encounter begins!You must burst hard at the start!
Type dps boss (you have 5 seconds).

Available commands: (in combat) wait, look, inventory, dodge (if asked), dps (if asked).

>dps boss
You unleash massive damage! Sindragosa shrieks in pain!
She begins casting Frost Explosion!
Run fast - type icy feet.

Available commands: (in combat) wait, look, inventory, dodge (if asked), dps (if asked).

>icy feet
You sprint away just in time - Frost Explosion misses you!
Sindragosa drops Ice Tombs - hide behind them!
Type hide.

Available commands: (in combat) wait, look, inventory, dodge (if asked), dps (if asked).

>hide
You hide behind the Ice Tombs and survive the ледeni удар!
Sindragosa lands again - finish her!
Type dps boss.

Available commands: (in combat) wait, look, inventory, dodge (if asked), dps (if asked).

>dps boss
Sindragosa is defeated!Loot drops: Rimetooth Pendant.
Type loot item to pick it up.

Available commands: fight, look, inventory, go <direction>.

>loot
Taken.

Available commands: fight, look, inventory, go <direction>.

>n
You can't go that way.

Available commands: fight, look, inventory, go <direction>.

>s
Trash 12
You can see Trash Pack 12 here.

Available commands: fight, look, inventory, go <direction>.

>fight
You engage the trash pack. The raid moves in!

Trash fight: the raid cleaves through undead...
You have successfully cleared the trash mobs. You can move on.

Available commands: fight, look, inventory, go <direction>.

>n
Boss Room 12
You can see a Lich King here.

Available commands: fight, look, inventory, go <direction>.

>fight
You pull the Lich King! The boss encounter begins!

The Lich King begins!He swings with Soul Reaper! Survive it!
Type use defensive (you have 5 seconds).

Available commands: (in combat) wait, look, inventory, dodge (if asked), dps (if asked).

>use defensive
No need for defensives here.

Available commands: (in combat) wait, look, inventory, dodge (if asked), dps (if asked).

>defensive
Too late! Soul Reaper cleaves you down.

Open World Graveyard
You are at the graveyard outside the raid because you are DEAD. The cold winds howls. Other spirits are whispering to you. Do not listen to them. Go to the light. You can only return by typing release spirit.

You died. Type release spirit.

>release
ICC Entrance
You are now at the ICC entrance inside the citadel. Next to you is a repair man and infront of you is the next room with enemy units.

You can see an Entrance Teleporter here.

You release your spirit and fly back to Icecrown Citadel. Status: ALIVE.

Your equipment is a bit damaged from dying.

You can still die and run back 2 more times before your gear becomes useless.

Available commands: go <direction>, look, inventory, die (debug), repair (if needed).

>teleport to 12
Boss Room 12
You can see a Lich King here.

You step into the teleporter... Destination reached.
Boss Room 12
You can see a Lich King here.

Available commands: fight, look, inventory, go <direction>.

>fight
You pull the Lich King! The boss encounter begins!

The Lich King begins!He swings with Soul Reaper! Survive it!
Type use defensive (you have 5 seconds).

Available commands: (in combat) wait, look, inventory, dodge (if asked), dps (if asked).

>defensive
No need for defensives here.

Available commands: (in combat) wait, look, inventory, dodge (if asked), dps (if asked).

>restart
Are you sure you want to restart?

* * *

Welcome to Icecrown Citadel, mortal. Status: ALIVE.

MAIN
An Interactive Fiction by Jan Pobi
Release 1 / Serial number 260112 / Inform 7 v10.1.2 / D

ICC Entrance
You are now at the ICC entrance inside the citadel. Next to you is a repair man and infront of you is the next room with enemy units.

You can see an Entrance Teleporter here.

>teleport to 12
Boss Room 12
You can see a Lich King here.

You step into the teleporter... Destination reached.
Boss Room 12
You can see a Lich King here.

Available commands: fight, look, inventory, go <direction>.

* * *

>defensive
No need for defensives here.

Available commands: (in combat) wait, look, inventory, dodge (if asked), dps (if asked).

>dps boss
Massive hit! The Lich King strides to the center of the platform!
Run to safety - type move to edge.

Available commands: (in combat) wait, look, inventory, dodge (if asked), dps (if asked).

>move
(the Lich King)
The Lich King might not like that.

Available commands: (in combat) wait, look, inventory, dodge (if asked), dps (if asked).

>move to edge
Too late! The shockwave catches you before you reach the edge.

Open World Graveyard
You are at the graveyard outside the raid because you are DEAD. The cold winds howls. Other spirits are whispering to you. Do not listen to them. Go to the light. You can only return by typing release spirit.

You died. Type release spirit.

>release
ICC Entrance
You are now at the ICC entrance inside the citadel. Next to you is a repair man and infront of you is the next room with enemy units.

You can see an Entrance Teleporter here.

You release your spirit and fly back to Icecrown Citadel. Status: ALIVE.

Your equipment is a bit damaged from dying.

You can still die and run back 2 more times before your gear becomes useless.

Available commands: go <direction>, look, inventory, die (debug), repair (if needed).

* * *

>fight
You pull the Lich King! The boss encounter begins!

The Lich King begins!He swings with Soul Reaper! Survive it!
Type use defensive (you have 5 seconds).

Available commands: (in combat) wait, look, inventory, dodge (if asked), dps (if asked).

>defensive
You pop a defensive and survive Soul Reaper!
Now punish him - type dps boss.

Available commands: (in combat) wait, look, inventory, dodge (if asked), dps (if asked).

>dps boss
Massive hit! The Lich King strides to the center of the platform!
Run to safety - type move to edge.

Available commands: (in combat) wait, look, inventory, dodge (if asked), dps (if asked).

>move to edge
You sprint to the edge of the platform!
Adds spawn - kill them: dps adds.

Available commands: (in combat) wait, look, inventory, dodge (if asked), dps (if asked).

>dps adds
Adds destroyed. Get back to the fight!
Type move to center.

Available commands: (in combat) wait, look, inventory, dodge (if asked), dps (if asked).

>move to center
You return to the center!
Now keep pressuring him - type dps boss.

Available commands: (in combat) wait, look, inventory, dodge (if asked), dps (if asked).

>dps boss
You punish the Lich King in the center!
Suddenly, val'kyr descend!
Stop them - type stun adds.

Available commands: (in combat) wait, look, inventory, dodge (if asked), dps (if asked).

>stun
You stun the val'kyr and the raid cleans them up!
The Lich King casts Defile - dodge it now!
Type move from defile.

Available commands: (in combat) wait, look, inventory, dodge (if asked), dps (if asked).

>move from defile
You move out of Defile just in time!
Finish him - type finish boss.

Available commands: (in combat) wait, look, inventory, dodge (if asked), dps (if asked).

>finish boss
No boss to finish here.

Available commands: (in combat) wait, look, inventory, dodge (if asked), dps (if asked).

* * *

>stun
You stun the val'kyr and the raid cleans them up!
The Lich King casts Defile - dodge it now!
Type move from defile.

Available commands: (in combat) wait, look, inventory, dodge (if asked), dps (if asked).

>move from defile
You move out of Defile just in time!
Finish him - type kill boss.

Available commands: (in combat) wait, look, inventory, dodge (if asked), dps (if asked).

>kill boss
THE LICH KING IS DEFEATED!Loot drops: Bloodsurge, Kel'Thuzad's Blade of Agony.
Type loot item to pick it up.

Available commands: fight, look, inventory, go <direction>.

A frozen teleporter forms beside the Lich King's throne.You can now use teleport list and teleport to <number> from here.

* * *

>move from defile
You move out of Defile just in time!
Finish him - type kill boss.

Available commands: (in combat) wait, look, inventory, dodge (if asked), dps (if asked).

>kill the litch king
You can't see any such thing.

>KILL THE LITCH KING
You can't see any such thing.

>kill boss
THE LICH KING IS DEFEATED!Loot drops: Oathbinder, Charge of the Ranger-General.
Type loot item to pick it up.

Available commands: fight, look, inventory, go <direction>.

A frozen teleporter forms beside the Lich King's throne.You can now use teleport list and teleport to <number> from here.

>look
Boss Room 12
You can see a Throne Teleporter, Oathbinder, Charge of the Ranger-General and a Lich King here.

The Lich King lies defeated on the cold stone.

Available commands: fight, look, inventory, go <direction>.

>loot item
Taken.

Available commands: fight, look, inventory, go <direction>.

>inventory
You are carrying:
  Oathbinder, Charge of the Ranger-General

Available commands: fight, look, inventory, go <direction>.

>look
Boss Room 12
You can see a Throne Teleporter and a Lich King here.

The Lich King lies defeated on the cold stone.

Available commands: fight, look, inventory, go <direction>.

>teleporter
Teleport destinations:
 - 1: Boss Room 1
 - 2: Boss Room 2
 - 3: Boss Room 3
 - 4: Boss Room 4
 - 5: Boss Room 5
 - 6: Boss Room 6
 - 7: Boss Room 7
 - 8: Boss Room 8
 - 9: Boss Room 9
 - 10: Boss Room 10
 - 11: Boss Room 11
 - 12: Boss Room 12

Use: teleport to <number>.

Available commands: fight, look, inventory, go <direction>.

>teleport to 1
Boss Room 1
You can see Lord Marrowgar here.

You step into the teleporter... Destination reached.
Boss Room 1
You can see Lord Marrowgar here.

Available commands: fight, look, inventory, go <direction>.

>s
Trash 1
You can see Trash Pack 1 here.

Available commands: fight, look, inventory, go <direction>.

* * *

>s
ICC Entrance
You are now at the ICC entrance inside the citadel. Next to you is a repair man and infront of you is the next room with enemy units.

You can see an Entrance Teleporter here.

Available commands: go <direction>, look, inventory, die (debug), repair (if needed).

>teleport to 12
Boss Room 12
You can see a Throne Teleporter and a Lich King here.

The Lich King lies defeated on the cold stone.

You step into the teleporter... Destination reached.
Boss Room 12
You can see a Throne Teleporter and a Lich King here.

The Lich King lies defeated on the cold stone.

Available commands: fight, look, inventory, go <direction>.

>fight
This boss is already defeated.

Available commands: fight, look, inventory, go <direction>.

>teleport to 3
Boss Room 3
You can see Gunship Battle here.

You step into the teleporter... Destination reached.
Boss Room 3
You can see Gunship Battle here.

Available commands: fight, look, inventory, go <direction>.

>fight
You pull Gunship Battle! The boss encounter begins!

Gunship Battle begins!To board the enemy ship, you must equip rocket.
Type equip rocket (you have 5 seconds).

Available commands: (in combat) wait, look, inventory, dodge (if asked), dps (if asked).

* * *

>equip rocket
You equip the rocket pack. Jump to the enemy ship!
Type board ship.

Available commands: (in combat) wait, look, inventory, dodge (if asked), dps (if asked).

>board
You rocket-jump onto the enemy ship!
A mage is freezing your cannons. Kill him!
Type dps mage.

Available commands: (in combat) wait, look, inventory, dodge (if asked), dps (if asked).

>dps
No need to DPS here.

Available commands: (in combat) wait, look, inventory, dodge (if asked), dps (if asked).

>dps mage
Too late! The mage freezes everything and the raid wipes.

Open World Graveyard
You are at the graveyard outside the raid because you are DEAD. The cold winds howls. Other spirits are whispering to you. Do not listen to them. Go to the light. You can only return by typing release spirit.

You died. Type release spirit.

>release spirit
ICC Entrance
You are now at the ICC entrance inside the citadel. Next to you is a repair man and infront of you is the next room with enemy units.

You can see an Entrance Teleporter here.

You release your spirit and fly back to Icecrown Citadel. Status: ALIVE.

Your equipment is a bit damaged from dying.

You can still die and run back 2 more times before your gear becomes useless.

Available commands: go <direction>, look, inventory, die (debug), repair (if needed).

>teleport to 3
Boss Room 3
You can see Gunship Battle here.

You step into the teleporter... Destination reached.
Boss Room 3
You can see Gunship Battle here.

Available commands: fight, look, inventory, go <direction>.

* * *

>board
You rocket-jump onto the enemy ship!
A mage is freezing your cannons. Kill him!
Type dps mage.

Available commands: (in combat) wait, look, inventory, dodge (if asked), dps (if asked).

>dps mage
Mage down! Cannons unfreeze!
Now return to your ship.
Type jump back.

Available commands: (in combat) wait, look, inventory, dodge (if asked), dps (if asked).

* * *

>dps adds
Gunship Battle is defeated!Loot drops: Ice-Reinforced Vrykul Helm.
Type loot item to pick it up.

Available commands: fight, look, inventory, go <direction>.

>inventory
You are carrying:
  Oathbinder, Charge of the Ranger-General

Available commands: fight, look, inventory, go <direction>.

>n
Trash 4
You can see Trash Pack 4 here.

Available commands: fight, look, inventory, go <direction>.

* * *

>fight
You pull Deathbringer Saurfang! The boss encounter begins!

Available commands: (in combat) wait, look, inventory, dodge (if asked), dps (if asked).

>dps boss
I only understood you as far as wanting to dps.

* * *

>dps
No need to DPS here.

Available commands: (in combat) wait, look, inventory, dodge (if asked), dps (if asked).

>dodge
No need to dodge here.

Available commands: (in combat) wait, look, inventory, dodge (if asked), dps (if asked).

>restart
Are you sure you want to restart?

* * *

>move from defile
You move out of Defile just in time!
Finish him - type kill boss.

Available commands: (in combat) wait, look, inventory, dodge (if asked), dps (if asked).

>move
(the Lich King)
The Lich King might not like that.

Available commands: (in combat) wait, look, inventory, dodge (if asked), dps (if asked).

>defile
That's not a verb I recognise.

* * *

>defensive
No need for defensives here.

Available commands: (in combat) wait, look, inventory, dodge (if asked), dps (if asked).

>use defensive
Too late! Soul Reaper cleaves you down.

Open World Graveyard
You are at the graveyard outside the raid because you are DEAD. The cold winds howls. Other spirits are whispering to you. Do not listen to them. Go to the light. You can only return by typing release spirit.

You died. Type release spirit.

>release
ICC Entrance
You are now at the ICC entrance inside the citadel. Next to you is a repair man and infront of you is the next room with enemy units.

You can see an Entrance Teleporter here.

You release your spirit and fly back to Icecrown Citadel. Status: ALIVE.

Your equipment is a bit damaged from dying.

You can still die and run back 2 more times before your gear becomes useless.

Available commands: go <direction>, look, inventory, die (debug), repair (if needed).

* * *

>fight
You pull the Lich King! The boss encounter begins!

The Lich King begins!He swings with Soul Reaper! Survive it!
Type use defensive (you have 5 seconds).

Available commands: (in combat) wait, look, inventory, dodge (if asked), dps (if asked).

>use defensive
You pop a defensive and survive Soul Reaper!
Now punish him - type smash litch king.

Available commands: (in combat) wait, look, inventory, dodge (if asked), dps (if asked).

>dps litch king
No boss to DPS here.

Available commands: (in combat) wait, look, inventory, dodge (if asked), dps (if asked).

>dps litch king
Too late! You fail to punish him and the raid collapses.

Open World Graveyard
You are at the graveyard outside the raid because you are DEAD. The cold winds howls. Other spirits are whispering to you. Do not listen to them. Go to the light. You can only return by typing release spirit.

You died. Type release spirit.

* * *

>use defensive
You pop a defensive and survive Soul Reaper!
Now punish him - type smash litch king.

Available commands: (in combat) wait, look, inventory, dodge (if asked), dps (if asked).

>smash litch king
No boss to DPS here.

Available commands: (in combat) wait, look, inventory, dodge (if asked), dps (if asked).

>dps
Too late! You fail to punish him and the raid collapses.

Open World Graveyard
You are at the graveyard outside the raid because you are DEAD. The cold winds howls. Other spirits are whispering to you. Do not listen to them. Go to the light. You can only return by typing release spirit.

You died. Type release spirit.

>release
ICC Entrance
You are now at the ICC entrance inside the citadel. Next to you is a repair man and infront of you is the next room with enemy units.

You can see an Entrance Teleporter here.

You release your spirit and fly back to Icecrown Citadel. Status: ALIVE.

Your equipment is a bit damaged from dying.

You can still die and run back 2 more times before your gear becomes useless.

Available commands: go <direction>, look, inventory, die (debug), repair (if needed).

* * *

>use defensive
You pop a defensive and survive Soul Reaper!
Now punish him - type smash litch king.

Available commands: (in combat) wait, look, inventory, dodge (if asked), dps (if asked).

>dps
No need to DPS here.

Available commands: (in combat) wait, look, inventory, dodge (if asked), dps (if asked).

>dodge
Too late! You fail to punish him and the raid collapses.

Open World Graveyard
You are at the graveyard outside the raid because you are DEAD. The cold winds howls. Other spirits are whispering to you. Do not listen to them. Go to the light. You can only return by typing release spirit.

You died. Type release spirit.

>release
ICC Entrance
You are now at the ICC entrance inside the citadel. Next to you is a repair man and infront of you is the next room with enemy units.

You can see an Entrance Teleporter here.

You release your spirit and fly back to Icecrown Citadel. Status: ALIVE.

Your equipment is a bit damaged from dying.

Careful: you can only die and run back 1 more time before your gear becomes useless.

Available commands: go <direction>, look, inventory, die (debug), repair (if needed).

* * *

Welcome to Icecrown Citadel, mortal. Status: ALIVE.

MAIN
An Interactive Fiction by Jan Pobi
Release 1 / Serial number 260112 / Inform 7 v10.1.2 / D

ICC Entrance
You are now at the ICC entrance inside the citadel. Next to you is a repair man and infront of you is the next room with enemy units.

You can see an Entrance Teleporter here.

>teleport to 2
Boss Room 2
You can see Lady Deathwhisper here.

You step into the teleporter... Destination reached.
Boss Room 2
You can see Lady Deathwhisper here.

Available commands: fight, look, inventory, go <direction>.

* * *

>dps boss
Her shield shatters! Lady Deathwhisper moves to the center!
Type finish boss to follow and kill her.

Available commands: (in combat) wait, look, inventory, dodge (if asked), dps (if asked).

>finish boss
Lady Deathwhisper is defeated!
Loot drops: Ghoul Commander's Cuirass.
Type loot item to pick it up.

Available commands: fight, look, inventory, go <direction>.

* * *

Welcome to Icecrown Citadel, mortal. Status: ALIVE.

MAIN
An Interactive Fiction by Jan Pobi
Release 1 / Serial number 260112 / Inform 7 v10.1.2 / D

ICC Entrance
You are now at the ICC entrance inside the citadel. Next to you is a repair man and infront of you is the next room with enemy units.

You can see an Entrance Teleporter here.

>teleport to 3
Boss Room 3
You can see Gunship Battle here.

You step into the teleporter... Destination reached.
Boss Room 3
You can see Gunship Battle here.

Available commands: fight, look, inventory, go <direction>.

* * *

>jump back
You jump back to your ship!
New enemy adds board your deck!
Type dps adds.

Available commands: (in combat) wait, look, inventory, dodge (if asked), dps (if asked).

>dps adds
Gunship Battle is defeated!
Loot drops: Saronite Gargoyle Cloak.
Type loot item to pick it up.

Available commands: fight, look, inventory, go <direction>.

>loot
Taken.

Available commands: fight, look, inventory, go <direction>.

>inventory
You are carrying:
  Saronite Gargoyle Cloak

Available commands: fight, look, inventory, go <direction>.

>teleport to 4
There is no teleporter here.

Available commands: fight, look, inventory, go <direction>.

>n
Trash 4
You can see Trash Pack 4 here.

Available commands: fight, look, inventory, go <direction>.

* * *

>n
Boss Room 4
You can see Deathbringer Saurfang here.

Available commands: fight, look, inventory, go <direction>.

>fight
You pull Deathbringer Saurfang! The boss encounter begins!

Deathbringer Saurfang begins!He summons blood beasts - kill the adds!
Type dps adds (you have 5 seconds).

Available commands: (in combat) wait, look, inventory, dodge (if asked), dps (if asked).

>dps adds
You destroy the adds! Saurfang grows stronger!
Pop DPS cooldowns - type use dps CD.

Available commands: (in combat) wait, look, inventory, dodge (if asked), dps (if asked).

>use dps cd
You unleash DPS cooldowns! Saurfang staggers!
But more adds spawn - kill them now: kill adds.

Available commands: (in combat) wait, look, inventory, dodge (if asked), dps (if asked).

>kill adds
Adds are dead! Saurfang is at the brink of death!
Finish him - type dps boss.

Available commands: (in combat) wait, look, inventory, dodge (if asked), dps (if asked).

>dps boss
Deathbringer Saurfang is defeated!
Loot drops: Soulcleave Pendant.
Type loot item to pick it up.

Available commands: fight, look, inventory, go <direction>.

>f
That's not a verb I recognise.

>n
You can't go that way.

Available commands: fight, look, inventory, go <direction>.

* * *

>w
You can't go that way.

Available commands: fight, look, inventory, go <direction>.

>e
Trash 5
You can see Trash Pack 5 here.

Available commands: fight, look, inventory, go <direction>.

>fight
You engage the trash pack. The raid moves in!

Trash fight: the raid cleaves through undead...
You have successfully cleared the trash mobs. You can move on.

Available commands: fight, look, inventory, go <direction>.

>n
You can't go that way.

Available commands: fight, look, inventory, go <direction>.

>e
Boss Room 5
You can see Festergut here.

Available commands: fight, look, inventory, go <direction>.

>fight
You pull Festergut! The boss encounter begins!

Festergut begins!An ooze spawns on you! Move it away from the raid!
Type move from raid (you have 5 seconds).

Available commands: (in combat) wait, look, inventory, dodge (if asked), dps (if asked).

* * *

>move from boss
You move away at the last second - Ooze Explosion misses you!
Finish him now - type dps boss.

Available commands: (in combat) wait, look, inventory, dodge (if asked), dps (if asked).

>dps boss
Festergut is defeated!
Loot drops: Precious's Putrid Collar.
Type loot item to pick it up.

Available commands: fight, look, inventory, go <direction>.

>loot
Taken.

Available commands: fight, look, inventory, go <direction>.

* * *

>n
You can't go that way.

Available commands: fight, look, inventory, go <direction>.

>w
Trash 6
You can see Trash Pack 6 here.

Available commands: fight, look, inventory, go <direction>.

* * *

>n
Boss Room 6
You can see Rotface here.

Available commands: fight, look, inventory, go <direction>.

>fight
You pull Rotface! The boss encounter begins!

Rotface begins!Spore appears on you! You must stack with the raid!
Type stack (you have 5 seconds).

Available commands: (in combat) wait, look, inventory, dodge (if asked), dps (if asked).

* * *

>defensive
You pop defensives and survive Vile Gas!
Finish him - type finish the boss.

Available commands: (in combat) wait, look, inventory, dodge (if asked), dps (if asked).

>finish the boss
Rotface is defeated!
Loot drops: Chestguard of the Failed Experiment.
Type loot item to pick it up.

Available commands: fight, look, inventory, go <direction>.

>loot
Taken.

Available commands: fight, look, inventory, go <direction>.

>inventory
You are carrying:
  Chestguard of the Failed Experiment
  Precious's Putrid Collar
  Saronite Gargoyle Cloak

Available commands: fight, look, inventory, go <direction>.

>n
You can't go that way.

Available commands: fight, look, inventory, go <direction>.

* * *

>w
You can't go that way.

Available commands: fight, look, inventory, go <direction>.

>s
Trash 7
You can see Trash Pack 7 here.

Available commands: fight, look, inventory, go <direction>.

* * *

>n
Boss Room 7
You can see Professor Putricide here.

Available commands: fight, look, inventory, go <direction>.

>fight
You pull Professor Putricide! The boss encounter begins!

Professor Putricide begins!He throws a volatile vial at your feet!
Move quickly - type move (you have 5 seconds).

Available commands: (in combat) wait, look, inventory, dodge (if asked), dps (if asked).

>move
You move away as the vile vial shatters!
A Green Ooze spawns! Kill it!
Type dps ooze.

Available commands: (in combat) wait, look, inventory, dodge (if asked), dps (if asked).

>dps ooze
The green ooze explodes harmlessly!
A Red Ooze forms - RUN!
Type run from ooze.

Available commands: (in combat) wait, look, inventory, dodge (if asked), dps (if asked).

>run from ooze
You successfully kite the red ooze!
Professor Putricide goes ENRAGE!Survive it - type defensive.

Available commands: (in combat) wait, look, inventory, dodge (if asked), dps (if asked).

>defensive
You survive the enrage!
Finish him - type dps boss.

Available commands: (in combat) wait, look, inventory, dodge (if asked), dps (if asked).

>dps boss
Professor Putricide is defeated!
Loot drops: Infected Choker.
Type loot item to pick it up.

Available commands: fight, look, inventory, go <direction>.

>loot
Taken.

Available commands: fight, look, inventory, go <direction>.

>n
Trash 8
You can see Trash Pack 8 here.

Available commands: fight, look, inventory, go <direction>.

* * *

>n
Boss Room 8
You can see Blood Prince Council here.

Available commands: fight, look, inventory, go <direction>.

>fight
You pull Blood Prince Council! The boss encounter begins!

Blood Prince Council begins!You must do damage with single target abilities only!
Type single target (you have 5 seconds).

Available commands: (in combat) wait, look, inventory, dodge (if asked), dps (if asked).

>single target
Perfect - you focus with single target damage only!
Suddenly a vortex forms on the floor!
Avoid it - type vortex.

Available commands: (in combat) wait, look, inventory, dodge (if asked), dps (if asked).

>vortex
You sidestep the vortex just in time!
One prince shifts into a clone form!
Switch target - type switch target.

Available commands: (in combat) wait, look, inventory, dodge (if asked), dps (if asked).

>switch target
You switch target instantly - perfect focus!
Finish them - type dps boss.

Available commands: (in combat) wait, look, inventory, dodge (if asked), dps (if asked).

>dps boss
Blood Prince Council is defeated!
Loot drops: Soulbreaker.
Type loot item to pick it up.

Available commands: fight, look, inventory, go <direction>.

>loot
Taken.

Available commands: fight, look, inventory, go <direction>.

* * *

>w
You can't go that way.

Available commands: fight, look, inventory, go <direction>.

>e
Trash 9
You can see Trash Pack 9 here.

Available commands: fight, look, inventory, go <direction>.

>fight
You engage the trash pack. The raid moves in!

Trash fight: the raid cleaves through undead...
You have successfully cleared the trash mobs. You can move on.

Available commands: fight, look, inventory, go <direction>.

* * *

>n
Boss Room 9
You can see Blood-Queen Lana'thel here.

Available commands: fight, look, inventory, go <direction>.

>fight
You pull Blood-Queen Lana'thel! The boss encounter begins!

Blood-Queen Lana'thel begins!She ignites the floor with bloodfire!
Move away - type move from fire (you have 5 seconds).

Available commands: (in combat) wait, look, inventory, dodge (if asked), dps (if asked).

>move from fire
You step out of the flames just in time!
She bites you with a blood curse!
To survive, bite the antidote - type bite.

Available commands: (in combat) wait, look, inventory, dodge (if asked), dps (if asked).

>bite
You bite the antidote and purge the curse!
Blood-Queen Lana'thel flies up and prepares a deadly burst!
Survive it - type defensive.

Available commands: (in combat) wait, look, inventory, dodge (if asked), dps (if asked).

>defensive
You use a defensive and survive the aerial burst!
She lands back down - finish her!
Type dps boss.

Available commands: (in combat) wait, look, inventory, dodge (if asked), dps (if asked).

>dps boss
Blood-Queen Lana'thel is defeated!
Loot drops: Bloodfall.
Type loot item to pick it up.

Available commands: fight, look, inventory, go <direction>.

>loot
Taken.

Available commands: fight, look, inventory, go <direction>.

>inventory
You are carrying:
  Bloodfall
  Soulbreaker
  Infected Choker
  Chestguard of the Failed Experiment
  Precious's Putrid Collar
  Saronite Gargoyle Cloak

Available commands: fight, look, inventory, go <direction>.

>n
Trash 10
You can see Trash Pack 10 here.

Available commands: fight, look, inventory, go <direction>.

>fi
That's not a verb I recognise.

>g
That's not a verb I recognise.

>fight
You engage the trash pack. The raid moves in!

Trash fight: the raid cleaves through undead...
You have successfully cleared the trash mobs. You can move on.

Available commands: fight, look, inventory, go <direction>.

* * *

>n
Boss Room 10
You can see Valithria Dreamwalker here.

Available commands: fight, look, inventory, go <direction>.

>fight
You pull Valithria Dreamwalker! The boss encounter begins!

Valithria Dreamwalker encounter begins!Adds flood the room - you must position correctly!
Go right - type right (you have 5 seconds).

Available commands: (in combat) wait, look, inventory, dodge (if asked), dps (if asked).

* * *

>dps skeleton
Blazing Skeleton destroyed!
Now support the healers - Valithria must be saved!
Type help healers.

Available commands: (in combat) wait, look, inventory, dodge (if asked), dps (if asked).

>help healers
Valithria Dreamwalker is saved!
Loot drops: ColdWrath Links belt.
Type loot item to pick it up.

Available commands: fight, look, inventory, go <direction>.

>loot
Taken.

Available commands: fight, look, inventory, go <direction>.

I beg your pardon?

>inventory
You are carrying:
  ColdWrath Links belt
  Bloodfall
  Soulbreaker
  Infected Choker
  Chestguard of the Failed Experiment
  Precious's Putrid Collar
  Saronite Gargoyle Cloak

Available commands: fight, look, inventory, go <direction>.

>look
Boss Room 10
You can see Valithria Dreamwalker here.

Valithria Dreamwalker lies defeated on the ground.

Available commands: fight, look, inventory, go <direction>.

>n
You can't go that way.

Available commands: fight, look, inventory, go <direction>.

* * *

>e
You can't go that way.

Available commands: fight, look, inventory, go <direction>.

>s
Trash 11
You can see Trash Pack 11 here.

Available commands: fight, look, inventory, go <direction>.

>fight
You engage the trash pack. The raid moves in!

Trash fight: the raid cleaves through undead...
You have successfully cleared the trash mobs. You can move on.

Available commands: fight, look, inventory, go <direction>.

* * *

>n
Boss Room 11
You can see Sindragosa here.

Available commands: fight, look, inventory, go <direction>.

>fight
You pull Sindragosa! The boss encounter begins!

Sindragosa encounter begins!You must burst hard at the start!
Type dps boss (you have 5 seconds).

Available commands: (in combat) wait, look, inventory, dodge (if asked), dps (if asked).

* * *

>hide
You hide behind the Ice Tombs and survive the ледeni удар!
Sindragosa lands again - finish her!
Type dps boss.

Available commands: (in combat) wait, look, inventory, dodge (if asked), dps (if asked).

>dps boss
Sindragosa is defeated!
Loot drops: Rimetooth Pendant.
Type loot item to pick it up.

Available commands: fight, look, inventory, go <direction>.

>loot
Taken.

Available commands: fight, look, inventory, go <direction>.

* * *

>use defensive
You pop a defensive and survive Soul Reaper!
Now punish him - type dps boss.

Available commands: (in combat) wait, look, inventory, dodge (if asked), dps (if asked).

>dps boss
Massive hit! The Lich King strides to the center of the platform!
Run to safety - type move to edge.

Available commands: (in combat) wait, look, inventory, dodge (if asked), dps (if asked).

* * *

>move to center
You return to the center!
Now keep pressuring him - type dps boss.

Available commands: (in combat) wait, look, inventory, dodge (if asked), dps (if asked).

I beg your pardon?

>dps boss
You punish the Lich King in the center!
Suddenly, val'kyr descend!
Stop them - type stun adds.

Available commands: (in combat) wait, look, inventory, dodge (if asked), dps (if asked).

>stun adds
You stun the val'kyr and the raid cleans them up!
The Lich King casts Defile - dodge it now!
Type move from defile.

Available commands: (in combat) wait, look, inventory, dodge (if asked), dps (if asked).

>move from defile
You move out of Defile just in time!
Finish him - type kill boss.

Available commands: (in combat) wait, look, inventory, dodge (if asked), dps (if asked).

>kill boss
THE LICH KING IS DEFEATED!
Loot drops: Oathbinder, Charge of the Ranger-General.
Type loot item to pick it up.

Available commands: fight, look, inventory, go <direction>.

A frozen teleporter forms beside the Lich King's throne.You can now use teleport list and teleport to <number> from here.

>teleport
Teleport destinations:
 - 1: Boss Room 1
 - 2: Boss Room 2
 - 3: Boss Room 3
 - 4: Boss Room 4
 - 5: Boss Room 5
 - 6: Boss Room 6
 - 7: Boss Room 7
 - 8: Boss Room 8
 - 9: Boss Room 9
 - 10: Boss Room 10
 - 11: Boss Room 11
 - 12: Boss Room 12

Use: teleport to <number>.

Available commands: fight, look, inventory, go <direction>.

>look
Boss Room 12
You can see a Throne Teleporter, Oathbinder, Charge of the Ranger-General and a Lich King here.

The Lich King lies defeated on the ground.

Available commands: fight, look, inventory, go <direction>.

>loot
Taken.

Available commands: fight, look, inventory, go <direction>.

>inventory
You are carrying:
  Oathbinder, Charge of the Ranger-General
  Rimetooth Pendant
  ColdWrath Links belt
  Bloodfall
  Soulbreaker
  Infected Choker
  Chestguard of the Failed Experiment
  Precious's Putrid Collar
  Saronite Gargoyle Cloak

Available commands: fight, look, inventory, go <direction>.

* * *

Welcome to Icecrown Citadel, mortal. Status: ALIVE.

MAIN
An Interactive Fiction by Jan Pobi
Release 1 / Serial number 260112 / Inform 7 v10.1.2 / D

ICC Entrance
You are now at the ICC entrance inside the citadel. Next to you is a repair man and infront of you is the next room with enemy units.

You can see an Entrance Teleporter here.

>teleport to 4
Boss Room 4
You can see Deathbringer Saurfang here.

You step into the teleporter... Destination reached.
Boss Room 4
You can see Deathbringer Saurfang here.

Available commands: fight, look, inventory, go <direction>.

>fight
You pull Deathbringer Saurfang! The boss encounter begins!

Deathbringer Saurfang begins!He summons blood beasts - kill the adds!
Type dps adds (you have 5 seconds).

Available commands: (in combat) wait, look, inventory, dodge (if asked), dps (if asked).

* * *

>dps adds
You destroy the adds! Saurfang grows stronger!
Pop DPS cooldowns - type use dps CD.

Available commands: (in combat) wait, look, inventory, dodge (if asked), dps (if asked).

>use dps CD
You unleash DPS cooldowns! Saurfang staggers!
But more adds spawn - kill them now: kill adds.

Available commands: (in combat) wait, look, inventory, dodge (if asked), dps (if asked).

>kill adds
Adds are dead! Saurfang is at the brink of death!
Finish him - type dps boss.

Available commands: (in combat) wait, look, inventory, dodge (if asked), dps (if asked).

>dps boss
Deathbringer Saurfang is defeated!Loot drops: Soulcleave Pendant.
Type loot item to pick it up.

Available commands: fight, look, inventory, go <direction>.

>loot item
Taken.

Available commands: fight, look, inventory, go <direction>.

>inventory
You are carrying:
  Soulcleave Pendant

Available commands: fight, look, inventory, go <direction>.

* * *

Welcome to Icecrown Citadel, mortal. Status: ALIVE.

MAIN
An Interactive Fiction by Jan Pobi
Release 1 / Serial number 260112 / Inform 7 v10.1.2 / D

ICC Entrance
You are now at the ICC entrance inside the citadel. Next to you is a repair man and infront of you is the next room with enemy units.

You can see an Entrance Teleporter here.

>teleport to 7
Boss Room 7
You can see Professor Putricide here.

You step into the teleporter... Destination reached.
Boss Room 7
You can see Professor Putricide here.

Available commands: fight, look, inventory, go <direction>.

>fight
You pull Professor Putricide! The boss encounter begins!

Professor Putricide begins!He throws a volatile vial at your feet!
Move quickly - type move (you have 5 seconds).

Available commands: (in combat) wait, look, inventory, dodge (if asked), dps (if asked).

* * *

>defensive
You survive the enrage!
Finish him - type dps boss.

Available commands: (in combat) wait, look, inventory, dodge (if asked), dps (if asked).

>defesive
That's not a verb I recognise.

>defensive
Too late! Enrage crushes the raid. Wipe.

Open World Graveyard
You are at the graveyard outside the raid because you are DEAD. The cold winds howls. Other spirits are whispering to you. Do not listen to them. Go to the light. You can only return by typing release spirit.

You died. Type release spirit.

>release
ICC Entrance
You are now at the ICC entrance inside the citadel. Next to you is a repair man and infront of you is the next room with enemy units.

You can see an Entrance Teleporter here.

You release your spirit and fly back to Icecrown Citadel. Status: ALIVE.

Your equipment is a bit damaged from dying.

You can still die and run back 2 more times before your gear becomes useless.

Available commands: go <direction>, look, inventory, die (debug), repair (if needed).

>release
You are not dead.

Available commands: go <direction>, look, inventory, die (debug), repair (if needed).

>teleport to 7
Boss Room 7
You can see Professor Putricide here.

You step into the teleporter... Destination reached.
Boss Room 7
You can see Professor Putricide here.

Available commands: fight, look, inventory, go <direction>.

* * *

>run from ooze
You successfully kite the red ooze!
Professor Putricide goes ENRAGE!Survive it - type defensive.

Available commands: (in combat) wait, look, inventory, dodge (if asked), dps (if asked).

>use defensive
No need for defensives here.

Available commands: (in combat) wait, look, inventory, dodge (if asked), dps (if asked).

>dps
Too late! Enrage crushes the raid. Wipe.

Open World Graveyard
You are at the graveyard outside the raid because you are DEAD. The cold winds howls. Other spirits are whispering to you. Do not listen to them. Go to the light. You can only return by typing release spirit.

You died. Type release spirit.

* * *

>defensive
You survive the enrage!
Finish him - type dps boss.

Available commands: (in combat) wait, look, inventory, dodge (if asked), dps (if asked).

>dps boss
Professor Putricide is defeated!Loot drops: Discarded Bag of Entrails.
Type loot item to pick it up.

Available commands: fight, look, inventory, go <direction>.

>loot
Taken.

Available commands: fight, look, inventory, go <direction>.

>inventory
You are carrying:
  Discarded Bag of Entrails

Available commands: fight, look, inventory, go <direction>.

>n
Trash 8
You can see Trash Pack 8 here.

Available commands: fight, look, inventory, go <direction>.

* * *

Welcome to Icecrown Citadel, mortal. Status: ALIVE.

MAIN
An Interactive Fiction by Jan Pobi
Release 1 / Serial number 260112 / Inform 7 v10.1.2 / D

ICC Entrance
You are now at the ICC entrance inside the citadel. Next to you is a repair man and infront of you is the next room with enemy units.

You can see an Entrance Teleporter here.

>teleport to 8
Boss Room 8
You can see Blood Prince Council here.

You step into the teleporter... Destination reached.
Boss Room 8
You can see Blood Prince Council here.

Available commands: fight, look, inventory, go <direction>.

>fight
You pull Blood Prince Council! The boss encounter begins!

Blood Prince Council begins!You must do damage with single target abilities only!
Type single target (you have 5 seconds).

Available commands: (in combat) wait, look, inventory, dodge (if asked), dps (if asked).

>dps
No need to DPS here.

Available commands: (in combat) wait, look, inventory, dodge (if asked), dps (if asked).

>singel taraget
That's not a verb I recognise.

>single target
Too late! You waste damage with AoE and the Council overwhelms the raid.

Open World Graveyard
You are at the graveyard outside the raid because you are DEAD. The cold winds howls. Other spirits are whispering to you. Do not listen to them. Go to the light. You can only return by typing release spirit.

You died. Type release spirit.

>release
ICC Entrance
You are now at the ICC entrance inside the citadel. Next to you is a repair man and infront of you is the next room with enemy units.

You can see an Entrance Teleporter here.

You release your spirit and fly back to Icecrown Citadel. Status: ALIVE.

Your equipment is a bit damaged from dying.

You can still die and run back 2 more times before your gear becomes useless.

Available commands: go <direction>, look, inventory, die (debug), repair (if needed).

>teleport to 8
Boss Room 8
You can see Blood Prince Council here.

You step into the teleporter... Destination reached.
Boss Room 8
You can see Blood Prince Council here.

Available commands: fight, look, inventory, go <direction>.

* * *

>switch target
You switch target instantly - perfect focus!
Finish them - type dps boss.

Available commands: (in combat) wait, look, inventory, dodge (if asked), dps (if asked).

>dps boss
Blood Prince Council is defeated!Loot drops: Soulbreaker.
Type loot item to pick it up.

Available commands: fight, look, inventory, go <direction>.

>look
Boss Room 8
You can see Soulbreaker and Blood Prince Council here.

Blood Prince Council lies defeated on the cold stone.

Available commands: fight, look, inventory, go <direction>.

>loot item
Taken.

Available commands: fight, look, inventory, go <direction>.

>inventory
You are carrying:
  Soulbreaker

Available commands: fight, look, inventory, go <direction>.

>fight
This boss is already defeated.

Available commands: fight, look, inventory, go <direction>.

>n
You can't go that way.

Available commands: fight, look, inventory, go <direction>.

* * *

>switch target
You switch target instantly - perfect focus!
Finish them - type dps boss.

Available commands: (in combat) wait, look, inventory, dodge (if asked), dps (if asked).

>dps boss
Blood Prince Council is defeated!Loot drops: Spaulders of the Blood Princes.
Type loot item to pick it up.

Available commands: fight, look, inventory, go <direction>.

>loot
Taken.

Available commands: fight, look, inventory, go <direction>.

* * *

Welcome to Icecrown Citadel, mortal. Status: ALIVE.

MAIN
An Interactive Fiction by Jan Pobi
Release 1 / Serial number 260112 / Inform 7 v10.1.2 / D

ICC Entrance
You are now at the ICC entrance inside the citadel. Next to you is a repair man and infront of you is the next room with enemy units.

You can see an Entrance Teleporter here.

>teleport to 9
Boss Room 9
You can see Blood-Queen Lana'thel here.

You step into the teleporter... Destination reached.
Boss Room 9
You can see Blood-Queen Lana'thel here.

Available commands: fight, look, inventory, go <direction>.

>fight
You pull Blood-Queen Lana'thel! The boss encounter begins!

Blood-Queen Lana'thel begins!She ignites the floor with bloodfire!
Move away - type move from fire (you have 5 seconds).

Available commands: (in combat) wait, look, inventory, dodge (if asked), dps (if asked).

* * *

>defensive
You use a defensive and survive the aerial burst!
She lands back down - finish her!
Type dps boss.

Available commands: (in combat) wait, look, inventory, dodge (if asked), dps (if asked).

>dps boss
Blood-Queen Lana'thel is defeated!Loot drops: Bloodfall.
Type loot item to pick it up.

Available commands: fight, look, inventory, go <direction>.

* * *

Welcome to Icecrown Citadel, mortal. Status: ALIVE.

MAIN
An Interactive Fiction by Jan Pobi
Release 1 / Serial number 260112 / Inform 7 v10.1.2 / D

ICC Entrance
You are now at the ICC entrance inside the citadel. Next to you is a repair man and infront of you is the next room with enemy units.

You can see an Entrance Teleporter here.

>teleporter
Teleport destinations:
 - 1: Boss Room 1
 - 2: Boss Room 2
 - 3: Boss Room 3
 - 4: Boss Room 4
 - 5: Boss Room 5
 - 6: Boss Room 6
 - 7: Boss Room 7
 - 8: Boss Room 8
 - 9: Boss Room 9
 - 10: Boss Room 10
 - 11: Boss Room 11
 - 12: Boss Room 12

Use: teleport to <number>.

Available commands: go <direction>, look, inventory, die (debug), repair (if needed).

>teleport to 12
Boss Room 12
You can see a Lich King here.

You step into the teleporter... Destination reached.
Boss Room 12
You can see a Lich King here.

Available commands: fight, look, inventory, go <direction>.

* * *

>smash litch king
No boss to DPS here.

Available commands: (in combat) wait, look, inventory, dodge (if asked), dps (if asked).

>dps boss
Too late! You fail to punish him and the raid collapses.

Open World Graveyard
You are at the graveyard outside the raid because you are DEAD. The cold winds howls. Other spirits are whispering to you. Do not listen to them. Go to the light. You can only return by typing release spirit.

You died. Type release spirit.

>release
ICC Entrance
You are now at the ICC entrance inside the citadel. Next to you is a repair man and infront of you is the next room with enemy units.

You can see an Entrance Teleporter here.

You release your spirit and fly back to Icecrown Citadel. Status: ALIVE.

Your equipment is a bit damaged from dying.

You can still die and run back 2 more times before your gear becomes useless.

Available commands: go <direction>, look, inventory, die (debug), repair (if needed).

* * *

>fight
You pull the Lich King! The boss encounter begins!

The Lich King begins!He swings with Soul Reaper! Survive it!
Type use defensive (you have 5 seconds).

Available commands: (in combat) wait, look, inventory, dodge (if asked), dps (if asked).

>defensive
You pop a defensive and survive Soul Reaper!
Now punish him - type smash litch king.

Available commands: (in combat) wait, look, inventory, dodge (if asked), dps (if asked).

>dps boss
Massive hit! The Lich King strides to the center of the platform!
Run to safety - type move to edge.

Available commands: (in combat) wait, look, inventory, dodge (if asked), dps (if asked).

* * *

>dps adds
Adds destroyed. Get back to the fight!
Type move to center.

Available commands: (in combat) wait, look, inventory, dodge (if asked), dps (if asked).

>move to center
You return to the center!
Now keep pressuring him - type smash litch king.

Available commands: (in combat) wait, look, inventory, dodge (if asked), dps (if asked).

>smash litch king
No boss to DPS here.

Available commands: (in combat) wait, look, inventory, dodge (if asked), dps (if asked).

>dps litch king
I only understood you as far as wanting to dps.

>dps boss
Too late! The val'kyr carry raid members into the abyss.

Open World Graveyard
You are at the graveyard outside the raid because you are DEAD. The cold winds howls. Other spirits are whispering to you. Do not listen to them. Go to the light. You can only return by typing release spirit.

You died. Type release spirit.

>release
ICC Entrance
You are now at the ICC entrance inside the citadel. Next to you is a repair man and infront of you is the next room with enemy units.

You can see an Entrance Teleporter here.

You release your spirit and fly back to Icecrown Citadel. Status: ALIVE.

Your equipment is a bit damaged from dying.

Careful: you can only die and run back 1 more time before your gear becomes useless.

Available commands: go <direction>, look, inventory, die (debug), repair (if needed).

>repair
You repair your gear. Everything feels solid again.

Available commands: go <direction>, look, inventory, die (debug), repair (if needed).

>teleport to 12
Boss Room 12
You can see a Lich King here.

You step into the teleporter... Destination reached.
Boss Room 12
You can see a Lich King here.

Available commands: fight, look, inventory, go <direction>.

* * *

>move to center
You return to the center!
Now keep pressuring him - type smash litch king.

Available commands: (in combat) wait, look, inventory, dodge (if asked), dps (if asked).

>dps boss
You punish the Lich King in the center!
Suddenly, val'kyr descend!
Stop them - type stun adds.

Available commands: (in combat) wait, look, inventory, dodge (if asked), dps (if asked).

>stun adds
You stun the val'kyr and the raid cleans them up!
The Lich King casts Defile - dodge it now!
Type dodge.

Available commands: (in combat) wait, look, inventory, dodge (if asked), dps (if asked).

>dodge
No need to dodge here.

Available commands: (in combat) wait, look, inventory, dodge (if asked), dps (if asked).

* * *

>y
Icecrown Citadel raid start. Status: ALIVE.

MAIN
An Interactive Fiction by Jan Pobi
Release 1 / Serial number 260108 / Inform 7 v10.1.2 / D

ICC Entrance
You are now at the ICC entrance inside the citadel. Next to you is a repair man and infront of you is the next room with enemy units.

You can see an Entrance Teleporter here.

>teleport
Teleport destinations:
 - 1: Boss Room 1
 - 2: Boss Room 2
 - 3: Boss Room 3
 - 4: Boss Room 4
 - 5: Boss Room 5
 - 6: Boss Room 6
 - 7: Boss Room 7
 - 8: Boss Room 8
 - 9: Boss Room 9
 - 10: Boss Room 10
 - 11: Boss Room 11
 - 12: Boss Room 12

Use: teleport to <number>.

Available commands: go <direction>, look, inventory, die (debug), repair (if needed).

* * *

>dps boss
You punish the Lich King in the center!
Suddenly, val'kyr descend!
Stop them - type stun adds.

Available commands: (in combat) wait, look, inventory, dodge (if asked), dps (if asked).

>stun
You stun the val'kyr and the raid cleans them up!
The Lich King casts Defile - dodge it now!
Type dodge.

Available commands: (in combat) wait, look, inventory, dodge (if asked), dps (if asked).

>move from defile
You can't see any such thing.

>move
(the Lich King)
The Lich King might not like that.

Available commands: (in combat) wait, look, inventory, dodge (if asked), dps (if asked).

>dps
Too late! The last moment is lost - wipe.

Open World Graveyard
You are at the graveyard outside the raid because you are DEAD. The cold winds howls. Other spirits are whispering to you. Do not listen to them. Go to the light. You can only return by typing release spirit.

You died. Type release spirit.

>release
ICC Entrance
You are now at the ICC entrance inside the citadel. Next to you is a repair man and infront of you is the next room with enemy units.

You can see an Entrance Teleporter here.

You release your spirit and fly back to Icecrown Citadel. Status: ALIVE.

Your equipment is a bit damaged from dying.

You can still die and run back 2 more times before your gear becomes useless.

Available commands: go <direction>, look, inventory, die (debug), repair (if needed).